Date,Type,residence,Positive,Negative,Total_Tests,Positive_Rate,Year,Month,Weekday
2020-08-16,Faculty/Staff,Non-Residential,0,3,3,0.0,2020,8,Sunday
2020-08-16,Students,Students - Non-Residential,1,34,35,2.86,2020,8,Sunday
2020-08-16,Students,Students - Residential,0,3,3,0.0,2020,8,Sunday
2020-08-17,Faculty/Staff,Non-Residential,0,56,56,0.0,2020,8,Monday
2020-08-17,Students,Students - Non-Residential,5,97,102,4.9,2020,8,Monday
2020-08-17,Students,Students - Residential,0,17,17,0.0,2020,8,Monday
2020-08-18,Faculty/Staff,Non-Residential,4,63,67,5.97,2020,8,Tuesday
2020-08-18,Students,Students - Non-Residential,6,74,80,7.5,2020,8,Tuesday
2020-08-18,Students,Students - Residential,2,23,25,8.0,2020,8,Tuesday
2020-08-19,Faculty/Staff,Non-Residential,3,40,43,6.98,2020,8,Wednesday
2020-08-19,Students,Students - Non-Residential,6,79,85,7.06,2020,8,Wednesday
2020-08-19,Students,Students - Residential,6,59,65,9.23,2020,8,Wednesday
2020-08-20,Faculty/Staff,Non-Residential,0,27,27,0.0,2020,8,Thursday
2020-08-20,Students,Students - Non-Residential,11,165,176,6.25,2020,8,Thursday
2020-08-20,Students,Students - Residential,6,88,94,6.38,2020,8,Thursday
2020-08-21,Faculty/Staff,Non-Residential,0,30,30,0.0,2020,8,Friday
2020-08-21,Students,Students - Non-Residential,4,94,98,4.08,2020,8,Friday
2020-08-21,Students,Students - Residential,9,76,85,10.59,2020,8,Friday
2020-08-22,Faculty/Staff,Non-Residential,0,3,3,0.0,2020,8,Saturday
2020-08-22,Students,Students - Non-Residential,5,42,47,10.64,2020,8,Saturday
2020-08-22,Students,Students - Residential,3,46,49,6.12,2020,8,Saturday
2020-08-23,Students,Students - Non-Residential,4,12,16,25.0,2020,8,Sunday
2020-08-23,Students,Students - Residential,2,51,53,3.77,2020,8,Sunday
2020-08-24,Faculty/Staff,Non-Residential,6,25,31,19.35,2020,8,Monday
2020-08-24,Students,Students - Non-Residential,13,161,174,7.47,2020,8,Monday
2020-08-24,Students,Students - Residential,3,161,164,1.83,2020,8,Monday
2020-08-25,Faculty/Staff,Non-Residential,0,37,37,0.0,2020,8,Tuesday
2020-08-25,Students,Students - Non-Residential,21,84,105,20.0,2020,8,Tuesday
2020-08-25,Students,Students - Residential,7,134,141,4.96,2020,8,Tuesday
2020-08-26,Faculty/Staff,Non-Residential,1,37,38,2.63,2020,8,Wednesday
2020-08-26,Students,Students - Non-Residential,12,98,110,10.91,2020,8,Wednesday
2020-08-26,Students,Students - Residential,3,98,101,2.97,2020,8,Wednesday
2020-08-27,Faculty/Staff,Non-Residential,0,14,14,0.0,2020,8,Thursday
2020-08-27,Students,Students - Non-Residential,12,168,180,6.67,2020,8,Thursday
2020-08-27,Students,Students - Residential,3,74,77,3.9,2020,8,Thursday
2020-08-28,Faculty/Staff,Non-Residential,1,29,30,3.33,2020,8,Friday
2020-08-28,Students,Students - Non-Residential,9,45,54,16.67,2020,8,Friday
2020-08-28,Students,Students - Residential,2,53,55,3.64,2020,8,Friday
2020-08-29,Faculty/Staff,Non-Residential,0,1,1,0.0,2020,8,Saturday
2020-08-29,Students,Students - Non-Residential,3,108,111,2.7,2020,8,Saturday
2020-08-29,Students,Students - Residential,3,53,56,5.36,2020,8,Saturday
2020-08-30,Faculty/Staff,Non-Residential,0,2,2,0.0,2020,8,Sunday
2020-08-30,Students,Students - Non-Residential,3,35,38,7.89,2020,8,Sunday
2020-08-30,Students,Students - Residential,1,13,14,7.14,2020,8,Sunday
2020-08-31,Faculty/Staff,Non-Residential,2,69,71,2.82,2020,8,Monday
2020-08-31,Students,Students - Non-Residential,1,85,86,1.16,2020,8,Monday
2020-08-31,Students,Students - Residential,1,61,62,1.61,2020,8,Monday
2020-09-01,Faculty/Staff,Non-Residential,1,41,42,2.38,2020,9,Tuesday
2020-09-01,Students,Students - Non-Residential,6,199,205,2.93,2020,9,Tuesday
2020-09-01,Students,Students - Residential,4,191,195,2.05,2020,9,Tuesday
2020-09-02,Faculty/Staff,Non-Residential,0,25,25,0.0,2020,9,Wednesday
2020-09-02,Students,Students - Non-Residential,11,160,171,6.43,2020,9,Wednesday
2020-09-02,Students,Students - Residential,4,173,177,2.26,2020,9,Wednesday
2020-09-03,Faculty/Staff,Non-Residential,1,22,23,4.35,2020,9,Thursday
2020-09-03,Students,Students - Non-Residential,7,189,196,3.57,2020,9,Thursday
2020-09-03,Students,Students - Residential,2,182,184,1.09,2020,9,Thursday
2020-09-04,Faculty/Staff,Non-Residential,2,72,74,2.7,2020,9,Friday
2020-09-04,Students,Students - Non-Residential,5,163,168,2.98,2020,9,Friday
2020-09-04,Students,Students - Residential,0,85,85,0.0,2020,9,Friday
2020-09-05,Faculty/Staff,Non-Residential,0,1,1,0.0,2020,9,Saturday
2020-09-05,Students,Students - Non-Residential,1,39,40,2.5,2020,9,Saturday
2020-09-05,Students,Students - Residential,1,19,20,5.0,2020,9,Saturday
2020-09-06,Faculty/Staff,Non-Residential,0,3,3,0.0,2020,9,Sunday
2020-09-06,Students,Students - Non-Residential,0,14,14,0.0,2020,9,Sunday
2020-09-06,Students,Students - Residential,1,6,7,14.29,2020,9,Sunday
2020-09-07,Faculty/Staff,Non-Residential,0,10,10,0.0,2020,9,Monday
2020-09-07,Students,Students - Non-Residential,8,33,41,19.51,2020,9,Monday
2020-09-07,Students,Students - Residential,1,35,36,2.78,2020,9,Monday
2020-09-08,Faculty/Staff,Non-Residential,0,89,89,0.0,2020,9,Tuesday
2020-09-08,Students,Students - Non-Residential,15,272,287,5.23,2020,9,Tuesday
2020-09-08,Students,Students - Residential,5,228,233,2.15,2020,9,Tuesday
2020-09-09,Faculty/Staff,Non-Residential,3,69,72,4.17,2020,9,Wednesday
2020-09-09,Students,Students - Non-Residential,13,226,239,5.44,2020,9,Wednesday
2020-09-09,Students,Students - Residential,5,154,159,3.14,2020,9,Wednesday
2020-09-10,Faculty/Staff,Non-Residential,3,42,45,6.67,2020,9,Thursday
2020-09-10,Students,Students - Non-Residential,7,216,223,3.14,2020,9,Thursday
2020-09-10,Students,Students - Residential,4,134,138,2.9,2020,9,Thursday
2020-09-11,Faculty/Staff,Non-Residential,1,83,84,1.19,2020,9,Friday
2020-09-11,Students,Students - Non-Residential,19,167,186,10.22,2020,9,Friday
2020-09-11,Students,Students - Residential,6,79,85,7.06,2020,9,Friday
2020-09-12,Faculty/Staff,Non-Residential,0,3,3,0.0,2020,9,Saturday
2020-09-12,Students,Students - Non-Residential,1,21,22,4.55,2020,9,Saturday
2020-09-12,Students,Students - Residential,2,36,38,5.26,2020,9,Saturday
2020-09-13,Faculty/Staff,Non-Residential,0,52,52,0.0,2020,9,Sunday
2020-09-13,Students,Students - Non-Residential,10,162,172,5.81,2020,9,Sunday
2020-09-13,Students,Students - Residential,4,120,124,3.23,2020,9,Sunday
2020-09-14,Faculty/Staff,Non-Residential,1,81,82,1.22,2020,9,Monday
2020-09-14,Students,Students - Non-Residential,9,114,123,7.32,2020,9,Monday
2020-09-14,Students,Students - Residential,33,572,605,5.45,2020,9,Monday
2020-09-15,Faculty/Staff,Non-Residential,2,27,29,6.9,2020,9,Tuesday
2020-09-15,Students,Students - Non-Residential,7,106,113,6.19,2020,9,Tuesday
2020-09-15,Students,Students - Residential,4,522,526,0.76,2020,9,Tuesday
2020-09-16,Faculty/Staff,Non-Residential,0,122,122,0.0,2020,9,Wednesday
2020-09-16,Students,Students - Non-Residential,10,208,218,4.59,2020,9,Wednesday
2020-09-16,Students,Students - Residential,4,456,460,0.87,2020,9,Wednesday
2020-09-17,Faculty/Staff,Non-Residential,0,98,98,0.0,2020,9,Thursday
2020-09-17,Students,Students - Non-Residential,1,81,82,1.22,2020,9,Thursday
2020-09-17,Students,Students - Residential,0,405,405,0.0,2020,9,Thursday
2020-09-18,Faculty/Staff,Non-Residential,0,71,71,0.0,2020,9,Friday
2020-09-18,Students,Students - Non-Residential,3,60,63,4.76,2020,9,Friday
2020-09-18,Students,Students - Residential,3,534,537,0.56,2020,9,Friday
2020-09-19,Faculty/Staff,Non-Residential,0,1,1,0.0,2020,9,Saturday
2020-09-19,Students,Students - Non-Residential,2,17,19,10.53,2020,9,Saturday
2020-09-19,Students,Students - Residential,1,66,67,1.49,2020,9,Saturday
2020-09-20,Faculty/Staff,Non-Residential,0,59,59,0.0,2020,9,Sunday
2020-09-20,Students,Students - Non-Residential,1,94,95,1.05,2020,9,Sunday
2020-09-20,Students,Students - Residential,1,56,57,1.75,2020,9,Sunday
2020-09-21,Faculty/Staff,Non-Residential,1,69,70,1.43,2020,9,Monday
2020-09-21,Students,Students - Non-Residential,3,100,103,2.91,2020,9,Monday
2020-09-21,Students,Students - Residential,6,482,488,1.23,2020,9,Monday
2020-09-22,Faculty/Staff,Non-Residential,1,38,39,2.56,2020,9,Tuesday
2020-09-22,Students,Students - Non-Residential,3,85,88,3.41,2020,9,Tuesday
2020-09-22,Students,Students - Residential,2,404,406,0.49,2020,9,Tuesday
2020-09-23,Faculty/Staff,Non-Residential,1,107,108,0.93,2020,9,Wednesday
2020-09-23,Students,Students - Non-Residential,1,161,162,0.62,2020,9,Wednesday
2020-09-23,Students,Students - Residential,6,508,514,1.17,2020,9,Wednesday
2020-09-24,Faculty/Staff,Non-Residential,0,83,83,0.0,2020,9,Thursday
2020-09-24,Students,Students - Non-Residential,0,76,76,0.0,2020,9,Thursday
2020-09-24,Students,Students - Residential,0,460,460,0.0,2020,9,Thursday
2020-09-25,Faculty/Staff,Non-Residential,0,93,93,0.0,2020,9,Friday
2020-09-25,Students,Students - Non-Residential,2,90,92,2.17,2020,9,Friday
2020-09-25,Students,Students - Residential,1,400,401,0.25,2020,9,Friday
2020-09-26,Faculty/Staff,Non-Residential,0,6,6,0.0,2020,9,Saturday
2020-09-26,Students,Students - Non-Residential,1,23,24,4.17,2020,9,Saturday
2020-09-26,Students,Students - Residential,0,14,14,0.0,2020,9,Saturday
2020-09-27,Faculty/Staff,Non-Residential,0,66,66,0.0,2020,9,Sunday
2020-09-27,Students,Students - Non-Residential,0,102,102,0.0,2020,9,Sunday
2020-09-27,Students,Students - Residential,0,59,59,0.0,2020,9,Sunday
2020-09-28,Faculty/Staff,Non-Residential,5,72,77,6.49,2020,9,Monday
2020-09-28,Students,Students - Non-Residential,1,522,523,0.19,2020,9,Monday
2020-09-28,Students,Students - Residential,0,498,498,0.0,2020,9,Monday
2020-09-29,Faculty/Staff,Non-Residential,2,64,66,3.03,2020,9,Tuesday
2020-09-29,Students,Students - Non-Residential,3,532,535,0.56,2020,9,Tuesday
2020-09-29,Students,Students - Residential,1,392,393,0.25,2020,9,Tuesday
2020-09-30,Faculty/Staff,Non-Residential,2,41,43,4.65,2020,9,Wednesday
2020-09-30,Students,Students - Non-Residential,1,588,589,0.17,2020,9,Wednesday
2020-09-30,Students,Students - Residential,2,443,445,0.45,2020,9,Wednesday
2020-10-01,Faculty/Staff,Non-Residential,1,144,145,0.69,2020,10,Thursday
2020-10-01,Students,Students - Non-Residential,0,493,493,0.0,2020,10,Thursday
2020-10-01,Students,Students - Residential,0,387,387,0.0,2020,10,Thursday
2020-10-02,Faculty/Staff,Non-Residential,2,51,53,3.77,2020,10,Friday
2020-10-02,Students,Students - Non-Residential,1,561,562,0.18,2020,10,Friday
2020-10-02,Students,Students - Residential,3,487,490,0.61,2020,10,Friday
2020-10-03,Faculty/Staff,Non-Residential,0,33,33,0.0,2020,10,Saturday
2020-10-03,Students,Students - Non-Residential,0,42,42,0.0,2020,10,Saturday
2020-10-03,Students,Students - Residential,0,15,15,0.0,2020,10,Saturday
2020-10-04,Faculty/Staff,Non-Residential,0,49,49,0.0,2020,10,Sunday
2020-10-04,Students,Students - Non-Residential,0,94,94,0.0,2020,10,Sunday
2020-10-04,Students,Students - Residential,0,43,43,0.0,2020,10,Sunday
2020-10-05,Faculty/Staff,Non-Residential,0,62,62,0.0,2020,10,Monday
2020-10-05,Students,Students - Non-Residential,1,477,478,0.21,2020,10,Monday
2020-10-05,Students,Students - Residential,2,486,488,0.41,2020,10,Monday
2020-10-06,Faculty/Staff,Non-Residential,1,73,74,1.35,2020,10,Tuesday
2020-10-06,Students,Students - Non-Residential,4,361,365,1.1,2020,10,Tuesday
2020-10-06,Students,Students - Residential,0,379,379,0.0,2020,10,Tuesday
2020-10-07,Faculty/Staff,Non-Residential,1,162,163,0.61,2020,10,Wednesday
2020-10-07,Students,Students - Non-Residential,3,373,376,0.8,2020,10,Wednesday
2020-10-07,Students,Students - Residential,0,367,367,0.0,2020,10,Wednesday
2020-10-08,Faculty/Staff,Non-Residential,1,37,38,2.63,2020,10,Thursday
2020-10-08,Students,Students - Non-Residential,2,196,198,1.01,2020,10,Thursday
2020-10-08,Students,Students - Residential,0,332,332,0.0,2020,10,Thursday
2020-10-09,Faculty/Staff,Non-Residential,1,62,63,1.59,2020,10,Friday
2020-10-09,Students,Students - Non-Residential,6,251,257,2.33,2020,10,Friday
2020-10-09,Students,Students - Residential,0,498,498,0.0,2020,10,Friday
2020-10-10,Faculty/Staff,Non-Residential,0,11,11,0.0,2020,10,Saturday
2020-10-10,Students,Students - Non-Residential,2,28,30,6.67,2020,10,Saturday
2020-10-10,Students,Students - Residential,0,14,14,0.0,2020,10,Saturday
2020-10-11,Faculty/Staff,Non-Residential,0,68,68,0.0,2020,10,Sunday
2020-10-11,Students,Students - Non-Residential,5,149,154,3.25,2020,10,Sunday
2020-10-11,Students,Students - Residential,0,66,66,0.0,2020,10,Sunday
2020-10-12,Faculty/Staff,Non-Residential,0,75,75,0.0,2020,10,Monday
2020-10-12,Students,Students - Non-Residential,4,549,553,0.72,2020,10,Monday
2020-10-12,Students,Students - Residential,1,503,504,0.2,2020,10,Monday
2020-10-13,Faculty/Staff,Non-Residential,0,64,64,0.0,2020,10,Tuesday
2020-10-13,Students,Students - Non-Residential,5,552,557,0.9,2020,10,Tuesday
2020-10-13,Students,Students - Residential,7,472,479,1.46,2020,10,Tuesday
2020-10-14,Faculty/Staff,Non-Residential,1,91,92,1.09,2020,10,Wednesday
2020-10-14,Students,Students - Non-Residential,5,575,580,0.86,2020,10,Wednesday
2020-10-14,Students,Students - Residential,5,487,492,1.02,2020,10,Wednesday
2020-10-15,Faculty/Staff,Non-Residential,1,138,139,0.72,2020,10,Thursday
2020-10-15,Students,Students - Non-Residential,10,525,535,1.87,2020,10,Thursday
2020-10-15,Students,Students - Residential,8,304,312,2.56,2020,10,Thursday
2020-10-16,Faculty/Staff,Non-Residential,1,48,49,2.04,2020,10,Friday
2020-10-16,Students,Students - Non-Residential,12,100,112,10.71,2020,10,Friday
2020-10-16,Students,Students - Residential,1,45,46,2.17,2020,10,Friday
2020-10-17,Faculty/Staff,Non-Residential,0,1,1,0.0,2020,10,Saturday
2020-10-17,Students,Students - Non-Residential,4,39,43,9.3,2020,10,Saturday
2020-10-17,Students,Students - Residential,0,12,12,0.0,2020,10,Saturday
2020-10-18,Faculty/Staff,Non-Residential,1,65,66,1.52,2020,10,Sunday
2020-10-18,Students,Students - Non-Residential,0,107,107,0.0,2020,10,Sunday
2020-10-18,Students,Students - Residential,0,53,53,0.0,2020,10,Sunday
2020-10-19,Faculty/Staff,Non-Residential,1,105,106,0.94,2020,10,Monday
2020-10-19,Students,Students - Non-Residential,15,523,538,2.79,2020,10,Monday
2020-10-19,Students,Students - Residential,5,388,393,1.27,2020,10,Monday
2020-10-20,Faculty/Staff,Non-Residential,1,68,69,1.45,2020,10,Tuesday
2020-10-20,Students,Students - Non-Residential,12,507,519,2.31,2020,10,Tuesday
2020-10-20,Students,Students - Residential,7,510,517,1.35,2020,10,Tuesday
2020-10-21,Faculty/Staff,Non-Residential,4,120,124,3.23,2020,10,Wednesday
2020-10-21,Students,Students - Non-Residential,6,397,403,1.49,2020,10,Wednesday
2020-10-21,Students,Students - Residential,9,445,454,1.98,2020,10,Wednesday
2020-10-22,Faculty/Staff,Non-Residential,2,123,125,1.6,2020,10,Thursday
2020-10-22,Students,Students - Non-Residential,6,476,482,1.24,2020,10,Thursday
2020-10-22,Students,Students - Residential,9,464,473,1.9,2020,10,Thursday
2020-10-23,Faculty/Staff,Non-Residential,4,58,62,6.45,2020,10,Friday
2020-10-23,Students,Students - Non-Residential,2,282,284,0.7,2020,10,Friday
2020-10-23,Students,Students - Residential,4,438,442,0.9,2020,10,Friday
2020-10-24,Faculty/Staff,Non-Residential,0,0,0,,2020,10,Saturday
2020-10-24,Students,Students - Non-Residential,1,14,15,6.67,2020,10,Saturday
2020-10-24,Students,Students - Residential,3,15,18,16.67,2020,10,Saturday
2020-10-25,Faculty/Staff,Non-Residential,1,41,42,2.38,2020,10,Sunday
2020-10-25,Students,Students - Non-Residential,2,104,106,1.89,2020,10,Sunday
2020-10-25,Students,Students - Residential,1,47,48,2.08,2020,10,Sunday
2020-10-26,Faculty/Staff,Non-Residential,3,129,132,2.27,2020,10,Monday
2020-10-26,Students,Students - Non-Residential,3,496,499,0.6,2020,10,Monday
2020-10-26,Students,Students - Residential,7,458,465,1.51,2020,10,Monday
2020-10-27,Faculty/Staff,Non-Residential,3,134,137,2.19,2020,10,Tuesday
2020-10-27,Students,Students - Non-Residential,7,572,579,1.21,2020,10,Tuesday
2020-10-27,Students,Students - Residential,3,526,529,0.57,2020,10,Tuesday
2020-10-28,Faculty/Staff,Non-Residential,3,120,123,2.44,2020,10,Wednesday
2020-10-28,Students,Students - Non-Residential,2,450,452,0.44,2020,10,Wednesday
2020-10-28,Students,Students - Residential,5,233,238,2.1,2020,10,Wednesday
2020-10-29,Faculty/Staff,Non-Residential,2,112,114,1.75,2020,10,Thursday
2020-10-29,Students,Students - Non-Residential,3,487,490,0.61,2020,10,Thursday
2020-10-29,Students,Students - Residential,2,356,358,0.56,2020,10,Thursday
2020-10-30,Faculty/Staff,Non-Residential,1,59,60,1.67,2020,10,Friday
2020-10-30,Students,Students - Non-Residential,4,233,237,1.69,2020,10,Friday
2020-10-30,Students,Students - Residential,2,355,357,0.56,2020,10,Friday
2020-10-31,Faculty/Staff,Non-Residential,1,0,1,100.0,2020,10,Saturday
2020-10-31,Students,Students - Non-Residential,1,13,14,7.14,2020,10,Saturday
2020-10-31,Students,Students - Residential,4,13,17,23.53,2020,10,Saturday
2020-11-01,Faculty/Staff,Non-Residential,0,5,5,0.0,2020,11,Sunday
2020-11-01,Students,Students - Non-Residential,0,12,12,0.0,2020,11,Sunday
2020-11-01,Students,Students - Residential,0,14,14,0.0,2020,11,Sunday
2020-11-02,Faculty/Staff,Non-Residential,3,138,141,2.13,2020,11,Monday
2020-11-02,Students,Students - Non-Residential,7,605,612,1.14,2020,11,Monday
2020-11-02,Students,Students - Residential,3,522,525,0.57,2020,11,Monday
2020-11-03,Faculty/Staff,Non-Residential,3,61,64,4.69,2020,11,Tuesday
2020-11-03,Students,Students - Non-Residential,13,539,552,2.36,2020,11,Tuesday
2020-11-03,Students,Students - Residential,10,502,512,1.95,2020,11,Tuesday
2020-11-04,Faculty/Staff,Non-Residential,2,160,162,1.23,2020,11,Wednesday
2020-11-04,Students,Students - Non-Residential,17,337,354,4.8,2020,11,Wednesday
2020-11-04,Students,Students - Residential,15,451,466,3.22,2020,11,Wednesday
2020-11-05,Faculty/Staff,Non-Residential,1,67,68,1.47,2020,11,Thursday
2020-11-05,Students,Students - Non-Residential,14,428,442,3.17,2020,11,Thursday
2020-11-05,Students,Students - Residential,8,378,386,2.07,2020,11,Thursday
2020-11-06,Faculty/Staff,Non-Residential,0,67,67,0.0,2020,11,Friday
2020-11-06,Students,Students - Non-Residential,16,307,323,4.95,2020,11,Friday
2020-11-06,Students,Students - Residential,12,342,354,3.39,2020,11,Friday
2020-11-07,Faculty/Staff,Non-Residential,2,72,74,2.7,2020,11,Saturday
2020-11-07,Students,Students - Non-Residential,6,148,154,3.9,2020,11,Saturday
2020-11-07,Students,Students - Residential,2,81,83,2.41,2020,11,Saturday
2020-11-08,Faculty/Staff,Non-Residential,0,2,2,0.0,2020,11,Sunday
2020-11-08,Students,Students - Non-Residential,3,54,57,5.26,2020,11,Sunday
2020-11-08,Students,Students - Residential,2,33,35,5.71,2020,11,Sunday
2020-11-09,Faculty/Staff,Non-Residential,8,90,98,8.16,2020,11,Monday
2020-11-09,Students,Students - Non-Residential,13,172,185,7.03,2020,11,Monday
2020-11-09,Students,Students - Residential,6,112,118,5.08,2020,11,Monday
2020-11-10,Faculty/Staff,Non-Residential,1,101,102,0.98,2020,11,Tuesday
2020-11-10,Students,Students - Non-Residential,23,565,588,3.91,2020,11,Tuesday
2020-11-10,Students,Students - Residential,14,388,402,3.48,2020,11,Tuesday
2020-11-11,Faculty/Staff,Non-Residential,5,122,127,3.94,2020,11,Wednesday
2020-11-11,Students,Students - Non-Residential,24,658,682,3.52,2020,11,Wednesday
2020-11-11,Students,Students - Residential,11,482,493,2.23,2020,11,Wednesday
2020-11-12,Faculty/Staff,Non-Residential,4,108,112,3.57,2020,11,Thursday
2020-11-12,Students,Students - Non-Residential,11,469,480,2.29,2020,11,Thursday
2020-11-12,Students,Students - Residential,39,394,433,9.01,2020,11,Thursday
2020-11-13,Faculty/Staff,Non-Residential,12,188,200,6.0,2020,11,Friday
2020-11-13,Students,Students - Non-Residential,14,453,467,3.0,2020,11,Friday
2020-11-13,Students,Students - Residential,17,453,470,3.62,2020,11,Friday
2020-11-14,Faculty/Staff,Non-Residential,0,16,16,0.0,2020,11,Saturday
2020-11-14,Students,Students - Non-Residential,3,76,79,3.8,2020,11,Saturday
2020-11-14,Students,Students - Residential,6,357,363,1.65,2020,11,Saturday
2020-11-15,Faculty/Staff,Non-Residential,6,57,63,9.52,2020,11,Sunday
2020-11-15,Students,Students - Non-Residential,16,101,117,13.68,2020,11,Sunday
2020-11-15,Students,Students - Residential,4,47,51,7.84,2020,11,Sunday
2020-11-16,Faculty/Staff,Non-Residential,15,165,180,8.33,2020,11,Monday
2020-11-16,Students,Students - Non-Residential,25,561,586,4.27,2020,11,Monday
2020-11-16,Students,Students - Residential,29,443,472,6.14,2020,11,Monday
2020-11-17,Faculty/Staff,Non-Residential,9,156,165,5.45,2020,11,Tuesday
2020-11-17,Students,Students - Non-Residential,15,472,487,3.08,2020,11,Tuesday
2020-11-17,Students,Students - Residential,21,291,312,6.73,2020,11,Tuesday
2020-11-18,Faculty/Staff,Non-Residential,5,137,142,3.52,2020,11,Wednesday
2020-11-18,Students,Students - Non-Residential,18,533,551,3.27,2020,11,Wednesday
2020-11-18,Students,Students - Residential,23,505,528,4.36,2020,11,Wednesday
2020-11-19,Faculty/Staff,Non-Residential,8,127,135,5.93,2020,11,Thursday
2020-11-19,Students,Students - Non-Residential,24,691,715,3.36,2020,11,Thursday
2020-11-19,Students,Students - Residential,45,711,756,5.95,2020,11,Thursday
2020-11-20,Faculty/Staff,Non-Residential,3,139,142,2.11,2020,11,Friday
2020-11-20,Students,Students - Non-Residential,8,243,251,3.19,2020,11,Friday
2020-11-20,Students,Students - Residential,2,83,85,2.35,2020,11,Friday
2020-11-21,Faculty/Staff,Non-Residential,0,15,15,0.0,2020,11,Saturday
2020-11-21,Students,Students - Non-Residential,6,98,104,5.77,2020,11,Saturday
2020-11-21,Students,Students - Residential,4,47,51,7.84,2020,11,Saturday
2020-11-22,Faculty/Staff,Non-Residential,4,64,68,5.88,2020,11,Sunday
2020-11-22,Students,Students - Non-Residential,9,128,137,6.57,2020,11,Sunday
2020-11-22,Students,Students - Residential,3,52,55,5.45,2020,11,Sunday
2020-11-23,Faculty/Staff,Non-Residential,7,127,134,5.22,2020,11,Monday
2020-11-23,Students,Students - Non-Residential,13,221,234,5.56,2020,11,Monday
2020-11-23,Students,Students - Residential,2,98,100,2.0,2020,11,Monday
2020-11-24,Faculty/Staff,Non-Residential,7,123,130,5.38,2020,11,Tuesday
2020-11-24,Students,Students - Non-Residential,6,189,195,3.08,2020,11,Tuesday
2020-11-24,Students,Students - Residential,3,75,78,3.85,2020,11,Tuesday
2020-11-25,Faculty/Staff,Non-Residential,9,71,80,11.25,2020,11,Wednesday
2020-11-25,Students,Students - Non-Residential,5,79,84,5.95,2020,11,Wednesday
2020-11-25,Students,Students - Residential,1,27,28,3.57,2020,11,Wednesday
2020-11-26,Faculty/Staff,Non-Residential,2,65,67,2.99,2020,11,Thursday
2020-11-26,Students,Students - Non-Residential,1,69,70,1.43,2020,11,Thursday
2020-11-26,Students,Students - Residential,0,30,30,0.0,2020,11,Thursday
2020-11-27,Faculty/Staff,Non-Residential,3,62,65,4.62,2020,11,Friday
2020-11-27,Students,Students - Non-Residential,6,50,56,10.71,2020,11,Friday
2020-11-27,Students,Students - Residential,1,18,19,5.26,2020,11,Friday
2020-11-28,Faculty/Staff,Non-Residential,1,53,54,1.85,2020,11,Saturday
2020-11-28,Students,Students - Non-Residential,3,75,78,3.85,2020,11,Saturday
2020-11-28,Students,Students - Residential,0,27,27,0.0,2020,11,Saturday
2020-11-29,Faculty/Staff,Non-Residential,2,3,5,40.0,2020,11,Sunday
2020-11-29,Students,Students - Non-Residential,3,19,22,13.64,2020,11,Sunday
2020-11-29,Students,Students - Residential,0,3,3,0.0,2020,11,Sunday
2020-11-30,Faculty/Staff,Non-Residential,10,107,117,8.55,2020,11,Monday
2020-11-30,Students,Students - Non-Residential,7,128,135,5.19,2020,11,Monday
2020-11-30,Students,Students - Residential,1,36,37,2.7,2020,11,Monday
2020-12-01,Faculty/Staff,Non-Residential,4,129,133,3.01,2020,12,Tuesday
2020-12-01,Students,Students - Non-Residential,3,140,143,2.1,2020,12,Tuesday
2020-12-01,Students,Students - Residential,0,69,69,0.0,2020,12,Tuesday
2020-12-02,Faculty/Staff,Non-Residential,5,115,120,4.17,2020,12,Wednesday
2020-12-02,Students,Students - Non-Residential,2,109,111,1.8,2020,12,Wednesday
2020-12-02,Students,Students - Residential,2,70,72,2.78,2020,12,Wednesday
2020-12-03,Faculty/Staff,Non-Residential,3,83,86,3.49,2020,12,Thursday
2020-12-03,Students,Students - Non-Residential,3,127,130,2.31,2020,12,Thursday
2020-12-03,Students,Students - Residential,1,32,33,3.03,2020,12,Thursday
2020-12-04,Faculty/Staff,Non-Residential,2,99,101,1.98,2020,12,Friday
2020-12-04,Students,Students - Non-Residential,2,99,101,1.98,2020,12,Friday
2020-12-04,Students,Students - Residential,0,24,24,0.0,2020,12,Friday
2020-12-05,Faculty/Staff,Non-Residential,0,12,12,0.0,2020,12,Saturday
2020-12-05,Students,Students - Non-Residential,1,44,45,2.22,2020,12,Saturday
2020-12-05,Students,Students - Residential,1,12,13,7.69,2020,12,Saturday
2020-12-06,Faculty/Staff,Non-Residential,1,49,50,2.0,2020,12,Sunday
2020-12-06,Students,Students - Non-Residential,0,73,73,0.0,2020,12,Sunday
2020-12-06,Students,Students - Residential,0,22,22,0.0,2020,12,Sunday
2020-12-07,Faculty/Staff,Non-Residential,2,158,160,1.25,2020,12,Monday
2020-12-07,Students,Students - Non-Residential,0,113,113,0.0,2020,12,Monday
2020-12-07,Students,Students - Residential,0,23,23,0.0,2020,12,Monday
2020-12-08,Faculty/Staff,Non-Residential,1,111,112,0.89,2020,12,Tuesday
2020-12-08,Students,Students - Non-Residential,1,168,169,0.59,2020,12,Tuesday
2020-12-08,Students,Students - Residential,0,67,67,0.0,2020,12,Tuesday
2020-12-09,Faculty/Staff,Non-Residential,5,113,118,4.24,2020,12,Wednesday
2020-12-09,Students,Students - Non-Residential,1,127,128,0.78,2020,12,Wednesday
2020-12-09,Students,Students - Residential,0,62,62,0.0,2020,12,Wednesday
2020-12-10,Faculty/Staff,Non-Residential,1,82,83,1.2,2020,12,Thursday
2020-12-10,Students,Students - Non-Residential,3,148,151,1.99,2020,12,Thursday
2020-12-10,Students,Students - Residential,0,36,36,0.0,2020,12,Thursday
2020-12-11,Faculty/Staff,Non-Residential,2,100,102,1.96,2020,12,Friday
2020-12-11,Students,Students - Non-Residential,1,119,120,0.83,2020,12,Friday
2020-12-11,Students,Students - Residential,1,30,31,3.23,2020,12,Friday
2020-12-12,Faculty/Staff,Non-Residential,0,7,7,0.0,2020,12,Saturday
2020-12-12,Students,Students - Non-Residential,2,19,21,9.52,2020,12,Saturday
2020-12-12,Students,Students - Residential,0,2,2,0.0,2020,12,Saturday
2020-12-13,Faculty/Staff,Non-Residential,2,76,78,2.56,2020,12,Sunday
2020-12-13,Students,Students - Non-Residential,3,94,97,3.09,2020,12,Sunday
2020-12-13,Students,Students - Residential,0,39,39,0.0,2020,12,Sunday
2020-12-14,Faculty/Staff,Non-Residential,1,112,113,0.88,2020,12,Monday
2020-12-14,Students,Students - Non-Residential,1,72,73,1.37,2020,12,Monday
2020-12-14,Students,Students - Residential,0,7,7,0.0,2020,12,Monday
2020-12-15,Faculty/Staff,Non-Residential,5,105,110,4.55,2020,12,Tuesday
2020-12-15,Students,Students - Non-Residential,0,195,195,0.0,2020,12,Tuesday
2020-12-15,Students,Students - Residential,0,68,68,0.0,2020,12,Tuesday
2020-12-16,Faculty/Staff,Non-Residential,3,95,98,3.06,2020,12,Wednesday
2020-12-16,Students,Students - Non-Residential,2,103,105,1.9,2020,12,Wednesday
2020-12-16,Students,Students - Residential,1,39,40,2.5,2020,12,Wednesday
2020-12-17,Faculty/Staff,Non-Residential,4,101,105,3.81,2020,12,Thursday
2020-12-17,Students,Students - Non-Residential,1,133,134,0.75,2020,12,Thursday
2020-12-17,Students,Students - Residential,0,32,32,0.0,2020,12,Thursday
2020-12-18,Faculty/Staff,Non-Residential,7,75,82,8.54,2020,12,Friday
2020-12-18,Students,Students - Non-Residential,1,92,93,1.08,2020,12,Friday
2020-12-18,Students,Students - Residential,0,29,29,0.0,2020,12,Friday
2020-12-19,Faculty/Staff,Non-Residential,1,2,3,33.33,2020,12,Saturday
2020-12-19,Students,Students - Non-Residential,1,26,27,3.7,2020,12,Saturday
2020-12-19,Students,Students - Residential,0,2,2,0.0,2020,12,Saturday
2020-12-20,Faculty/Staff,Non-Residential,1,16,17,5.88,2020,12,Sunday
2020-12-20,Students,Students - Non-Residential,0,34,34,0.0,2020,12,Sunday
2020-12-20,Students,Students - Residential,0,8,8,0.0,2020,12,Sunday
2020-12-21,Faculty/Staff,Non-Residential,8,117,125,6.4,2020,12,Monday
2020-12-21,Students,Students - Non-Residential,4,108,112,3.57,2020,12,Monday
2020-12-21,Students,Students - Residential,0,22,22,0.0,2020,12,Monday
2020-12-22,Faculty/Staff,Non-Residential,6,72,78,7.69,2020,12,Tuesday
2020-12-22,Students,Students - Non-Residential,2,104,106,1.89,2020,12,Tuesday
2020-12-22,Students,Students - Residential,2,45,47,4.26,2020,12,Tuesday
2020-12-23,Faculty/Staff,Non-Residential,3,116,119,2.52,2020,12,Wednesday
2020-12-23,Students,Students - Non-Residential,2,107,109,1.83,2020,12,Wednesday
2020-12-23,Students,Students - Residential,1,37,38,2.63,2020,12,Wednesday
2020-12-24,Faculty/Staff,Non-Residential,2,59,61,3.28,2020,12,Thursday
2020-12-24,Students,Students - Non-Residential,1,38,39,2.56,2020,12,Thursday
2020-12-24,Students,Students - Residential,0,17,17,0.0,2020,12,Thursday
2020-12-25,Faculty/Staff,Non-Residential,3,3,6,50.0,2020,12,Friday
2020-12-25,Students,Students - Non-Residential,1,3,4,25.0,2020,12,Friday
2020-12-26,Faculty/Staff,Non-Residential,0,61,61,0.0,2020,12,Saturday
2020-12-26,Students,Students - Non-Residential,0,74,74,0.0,2020,12,Saturday
2020-12-26,Students,Students - Residential,0,31,31,0.0,2020,12,Saturday
2020-12-27,Faculty/Staff,Non-Residential,1,56,57,1.75,2020,12,Sunday
2020-12-27,Students,Students - Non-Residential,0,70,70,0.0,2020,12,Sunday
2020-12-27,Students,Students - Residential,0,26,26,0.0,2020,12,Sunday
2020-12-28,Faculty/Staff,Non-Residential,4,121,125,3.2,2020,12,Monday
2020-12-28,Students,Students - Non-Residential,1,43,44,2.27,2020,12,Monday
2020-12-28,Students,Students - Residential,0,17,17,0.0,2020,12,Monday
2020-12-29,Faculty/Staff,Non-Residential,2,57,59,3.39,2020,12,Tuesday
2020-12-29,Students,Students - Non-Residential,0,57,57,0.0,2020,12,Tuesday
2020-12-29,Students,Students - Residential,1,29,30,3.33,2020,12,Tuesday
2020-12-30,Faculty/Staff,Non-Residential,5,111,116,4.31,2020,12,Wednesday
2020-12-30,Students,Students - Non-Residential,0,88,88,0.0,2020,12,Wednesday
2020-12-30,Students,Students - Residential,0,37,37,0.0,2020,12,Wednesday
2020-12-31,Faculty/Staff,Non-Residential,1,43,44,2.27,2020,12,Thursday
2020-12-31,Students,Students - Non-Residential,1,25,26,3.85,2020,12,Thursday
2020-12-31,Students,Students - Residential,0,5,5,0.0,2020,12,Thursday
2021-01-01,Faculty/Staff,Non-Residential,0,34,34,0.0,2021,1,Friday
2021-01-01,Students,Students - Non-Residential,0,23,23,0.0,2021,1,Friday
2021-01-01,Students,Students - Residential,0,15,15,0.0,2021,1,Friday
2021-01-02,Faculty/Staff,Non-Residential,0,8,8,0.0,2021,1,Saturday
2021-01-02,Students,Students - Non-Residential,2,45,47,4.26,2021,1,Saturday
2021-01-02,Students,Students - Residential,0,8,8,0.0,2021,1,Saturday
2021-01-03,Faculty/Staff,Non-Residential,0,39,39,0.0,2021,1,Sunday
2021-01-03,Students,Students - Non-Residential,1,73,74,1.35,2021,1,Sunday
2021-01-03,Students,Students - Residential,0,34,34,0.0,2021,1,Sunday
2021-01-04,Faculty/Staff,Non-Residential,4,163,167,2.4,2021,1,Monday
2021-01-04,Students,Students - Non-Residential,3,383,386,0.78,2021,1,Monday
2021-01-04,Students,Students - Residential,0,16,16,0.0,2021,1,Monday
2021-01-05,Faculty/Staff,Non-Residential,5,105,110,4.55,2021,1,Tuesday
2021-01-05,Students,Students - Non-Residential,5,167,172,2.91,2021,1,Tuesday
2021-01-05,Students,Students - Residential,1,46,47,2.13,2021,1,Tuesday
2021-01-06,Faculty/Staff,Non-Residential,10,136,146,6.85,2021,1,Wednesday
2021-01-06,Students,Students - Non-Residential,8,302,310,2.58,2021,1,Wednesday
2021-01-06,Students,Students - Residential,0,26,26,0.0,2021,1,Wednesday
2021-01-07,Faculty/Staff,Non-Residential,3,79,82,3.66,2021,1,Thursday
2021-01-07,Students,Students - Non-Residential,3,78,81,3.7,2021,1,Thursday
2021-01-07,Students,Students - Residential,0,22,22,0.0,2021,1,Thursday
2021-01-08,Faculty/Staff,Non-Residential,5,121,126,3.97,2021,1,Friday
2021-01-08,Students,Students - Non-Residential,2,139,141,1.42,2021,1,Friday
2021-01-08,Students,Students - Residential,0,29,29,0.0,2021,1,Friday
2021-01-09,Faculty/Staff,Non-Residential,1,3,4,25.0,2021,1,Saturday
2021-01-09,Students,Students - Non-Residential,2,16,18,11.11,2021,1,Saturday
2021-01-09,Students,Students - Residential,1,7,8,12.5,2021,1,Saturday
2021-01-10,Faculty/Staff,Non-Residential,1,36,37,2.7,2021,1,Sunday
2021-01-10,Students,Students - Non-Residential,2,69,71,2.82,2021,1,Sunday
2021-01-10,Students,Students - Residential,1,24,25,4.0,2021,1,Sunday
2021-01-11,Faculty/Staff,Non-Residential,5,164,169,2.96,2021,1,Monday
2021-01-11,Students,Students - Non-Residential,5,411,416,1.2,2021,1,Monday
2021-01-11,Students,Students - Residential,1,23,24,4.17,2021,1,Monday
2021-01-12,Faculty/Staff,Non-Residential,5,68,73,6.85,2021,1,Tuesday
2021-01-12,Students,Students - Non-Residential,3,125,128,2.34,2021,1,Tuesday
2021-01-12,Students,Students - Residential,0,59,59,0.0,2021,1,Tuesday
2021-01-13,Faculty/Staff,Non-Residential,2,129,131,1.53,2021,1,Wednesday
2021-01-13,Students,Students - Non-Residential,5,358,363,1.38,2021,1,Wednesday
2021-01-13,Students,Students - Residential,0,49,49,0.0,2021,1,Wednesday
2021-01-14,Faculty/Staff,Non-Residential,10,86,96,10.42,2021,1,Thursday
2021-01-14,Students,Students - Non-Residential,1,126,127,0.79,2021,1,Thursday
2021-01-14,Students,Students - Residential,1,40,41,2.44,2021,1,Thursday
2021-01-15,Faculty/Staff,Non-Residential,3,61,64,4.69,2021,1,Friday
2021-01-15,Students,Students - Non-Residential,1,107,108,0.93,2021,1,Friday
2021-01-15,Students,Students - Residential,0,36,36,0.0,2021,1,Friday
2021-01-16,Faculty/Staff,Non-Residential,0,4,4,0.0,2021,1,Saturday
2021-01-16,Students,Students - Non-Residential,1,39,40,2.5,2021,1,Saturday
2021-01-16,Students,Students - Residential,3,104,107,2.8,2021,1,Saturday
2021-01-17,Faculty/Staff,Non-Residential,1,35,36,2.78,2021,1,Sunday
2021-01-17,Students,Students - Non-Residential,2,43,45,4.44,2021,1,Sunday
2021-01-17,Students,Students - Residential,0,25,25,0.0,2021,1,Sunday
2021-01-18,Faculty/Staff,Non-Residential,4,70,74,5.41,2021,1,Monday
2021-01-18,Students,Students - Non-Residential,5,154,159,3.14,2021,1,Monday
2021-01-18,Students,Students - Residential,1,93,94,1.06,2021,1,Monday
2021-01-19,Faculty/Staff,Non-Residential,8,115,123,6.5,2021,1,Tuesday
2021-01-19,Students,Students - Non-Residential,10,325,335,2.99,2021,1,Tuesday
2021-01-19,Students,Students - Residential,3,459,462,0.65,2021,1,Tuesday
2021-01-20,Faculty/Staff,Non-Residential,4,168,172,2.33,2021,1,Wednesday
2021-01-20,Students,Students - Non-Residential,7,830,837,0.84,2021,1,Wednesday
2021-01-20,Students,Students - Residential,4,459,463,0.86,2021,1,Wednesday
2021-01-21,Faculty/Staff,Non-Residential,2,71,73,2.74,2021,1,Thursday
2021-01-21,Students,Students - Non-Residential,2,653,655,0.31,2021,1,Thursday
2021-01-21,Students,Students - Residential,6,606,612,0.98,2021,1,Thursday
2021-01-22,Faculty/Staff,Non-Residential,4,110,114,3.51,2021,1,Friday
2021-01-22,Students,Students - Non-Residential,10,922,932,1.07,2021,1,Friday
2021-01-22,Students,Students - Residential,3,696,699,0.43,2021,1,Friday
2021-01-23,Faculty/Staff,Non-Residential,1,19,20,5.0,2021,1,Saturday
2021-01-23,Students,Students - Non-Residential,9,378,387,2.33,2021,1,Saturday
2021-01-23,Students,Students - Residential,0,334,334,0.0,2021,1,Saturday
2021-01-24,Faculty/Staff,Non-Residential,0,112,112,0.0,2021,1,Sunday
2021-01-24,Students,Students - Non-Residential,12,1038,1050,1.14,2021,1,Sunday
2021-01-24,Students,Students - Residential,7,694,701,1.0,2021,1,Sunday
2021-01-25,Faculty/Staff,Non-Residential,4,115,119,3.36,2021,1,Monday
2021-01-25,Students,Students - Non-Residential,8,865,873,0.92,2021,1,Monday
2021-01-25,Students,Students - Residential,7,939,946,0.74,2021,1,Monday
2021-01-26,Faculty/Staff,Non-Residential,1,188,189,0.53,2021,1,Tuesday
2021-01-26,Students,Students - Non-Residential,6,636,642,0.93,2021,1,Tuesday
2021-01-26,Students,Students - Residential,4,738,742,0.54,2021,1,Tuesday
2021-01-27,Faculty/Staff,Non-Residential,3,110,113,2.65,2021,1,Wednesday
2021-01-27,Students,Students - Non-Residential,21,794,815,2.58,2021,1,Wednesday
2021-01-27,Students,Students - Residential,4,601,605,0.66,2021,1,Wednesday
2021-01-28,Faculty/Staff,Non-Residential,6,82,88,6.82,2021,1,Thursday
2021-01-28,Students,Students - Non-Residential,13,519,532,2.44,2021,1,Thursday
2021-01-28,Students,Students - Residential,8,533,541,1.48,2021,1,Thursday
2021-01-29,Faculty/Staff,Non-Residential,0,74,74,0.0,2021,1,Friday
2021-01-29,Students,Students - Non-Residential,9,499,508,1.77,2021,1,Friday
2021-01-29,Students,Students - Residential,4,210,214,1.87,2021,1,Friday
2021-01-30,Faculty/Staff,Non-Residential,1,38,39,2.56,2021,1,Saturday
2021-01-30,Students,Students - Non-Residential,3,116,119,2.52,2021,1,Saturday
2021-01-30,Students,Students - Residential,5,51,56,8.93,2021,1,Saturday
2021-01-31,Faculty/Staff,Non-Residential,0,30,30,0.0,2021,1,Sunday
2021-01-31,Students,Students - Non-Residential,6,51,57,10.53,2021,1,Sunday
2021-01-31,Students,Students - Residential,6,22,28,21.43,2021,1,Sunday
2021-02-01,Faculty/Staff,Non-Residential,5,122,127,3.94,2021,2,Monday
2021-02-01,Students,Students - Non-Residential,52,1182,1234,4.21,2021,2,Monday
2021-02-01,Students,Students - Residential,84,958,1042,8.06,2021,2,Monday
2021-02-02,Faculty/Staff,Non-Residential,2,108,110,1.82,2021,2,Tuesday
2021-02-02,Students,Students - Non-Residential,45,1012,1057,4.26,2021,2,Tuesday
2021-02-02,Students,Students - Residential,55,884,939,5.86,2021,2,Tuesday
2021-02-03,Faculty/Staff,Non-Residential,1,118,119,0.84,2021,2,Wednesday
2021-02-03,Students,Students - Non-Residential,32,1027,1059,3.02,2021,2,Wednesday
2021-02-03,Students,Students - Residential,31,675,706,4.39,2021,2,Wednesday
2021-02-04,Faculty/Staff,Non-Residential,4,106,110,3.64,2021,2,Thursday
2021-02-04,Students,Students - Non-Residential,17,802,819,2.08,2021,2,Thursday
2021-02-04,Students,Students - Residential,24,641,665,3.61,2021,2,Thursday
2021-02-05,Faculty/Staff,Non-Residential,1,105,106,0.94,2021,2,Friday
2021-02-05,Students,Students - Non-Residential,12,549,561,2.14,2021,2,Friday
2021-02-05,Students,Students - Residential,9,277,286,3.15,2021,2,Friday
2021-02-06,Faculty/Staff,Non-Residential,1,4,5,20.0,2021,2,Saturday
2021-02-06,Students,Students - Non-Residential,4,54,58,6.9,2021,2,Saturday
2021-02-06,Students,Students - Residential,7,46,53,13.21,2021,2,Saturday
2021-02-07,Faculty/Staff,Non-Residential,0,29,29,0.0,2021,2,Sunday
2021-02-07,Students,Students - Non-Residential,2,80,82,2.44,2021,2,Sunday
2021-02-07,Students,Students - Residential,7,72,79,8.86,2021,2,Sunday
2021-02-08,Faculty/Staff,Non-Residential,3,133,136,2.21,2021,2,Monday
2021-02-08,Students,Students - Non-Residential,13,1083,1096,1.19,2021,2,Monday
2021-02-08,Students,Students - Residential,20,911,931,2.15,2021,2,Monday
2021-02-09,Faculty/Staff,Non-Residential,3,118,121,2.48,2021,2,Tuesday
2021-02-09,Students,Students - Non-Residential,7,1124,1131,0.62,2021,2,Tuesday
2021-02-09,Students,Students - Residential,30,846,876,3.42,2021,2,Tuesday
2021-02-10,Faculty/Staff,Non-Residential,2,146,148,1.35,2021,2,Wednesday
2021-02-10,Students,Students - Non-Residential,5,1212,1217,0.41,2021,2,Wednesday
2021-02-10,Students,Students - Residential,16,614,630,2.54,2021,2,Wednesday
2021-02-11,Faculty/Staff,Non-Residential,3,103,106,2.83,2021,2,Thursday
2021-02-11,Students,Students - Non-Residential,9,807,816,1.1,2021,2,Thursday
2021-02-11,Students,Students - Residential,9,565,574,1.57,2021,2,Thursday
2021-02-12,Faculty/Staff,Non-Residential,0,101,101,0.0,2021,2,Friday
2021-02-12,Students,Students - Non-Residential,5,511,516,0.97,2021,2,Friday
2021-02-12,Students,Students - Residential,6,251,257,2.33,2021,2,Friday
2021-02-13,Faculty/Staff,Non-Residential,0,0,0,,2021,2,Saturday
2021-02-13,Students,Students - Non-Residential,1,39,40,2.5,2021,2,Saturday
2021-02-13,Students,Students - Residential,2,21,23,8.7,2021,2,Saturday
2021-02-14,Faculty/Staff,Non-Residential,0,18,18,0.0,2021,2,Sunday
2021-02-14,Students,Students - Non-Residential,0,83,83,0.0,2021,2,Sunday
2021-02-14,Students,Students - Residential,1,47,48,2.08,2021,2,Sunday
2021-02-15,Faculty/Staff,Non-Residential,2,127,129,1.55,2021,2,Monday
2021-02-15,Students,Students - Non-Residential,2,1187,1189,0.17,2021,2,Monday
2021-02-15,Students,Students - Residential,4,497,501,0.8,2021,2,Monday
2021-02-16,Faculty/Staff,Non-Residential,0,98,98,0.0,2021,2,Tuesday
2021-02-16,Students,Students - Non-Residential,4,893,897,0.45,2021,2,Tuesday
2021-02-16,Students,Students - Residential,1,523,524,0.19,2021,2,Tuesday
2021-02-17,Faculty/Staff,Non-Residential,2,160,162,1.23,2021,2,Wednesday
2021-02-17,Students,Students - Non-Residential,2,1135,1137,0.18,2021,2,Wednesday
2021-02-17,Students,Students - Residential,2,408,410,0.49,2021,2,Wednesday
2021-02-18,Faculty/Staff,Non-Residential,0,79,79,0.0,2021,2,Thursday
2021-02-18,Students,Students - Non-Residential,1,686,687,0.15,2021,2,Thursday
2021-02-18,Students,Students - Residential,3,444,447,0.67,2021,2,Thursday
2021-02-19,Faculty/Staff,Non-Residential,0,101,101,0.0,2021,2,Friday
2021-02-19,Students,Students - Non-Residential,1,507,508,0.2,2021,2,Friday
2021-02-19,Students,Students - Residential,2,220,222,0.9,2021,2,Friday
2021-02-20,Students,Students - Non-Residential,0,19,19,0.0,2021,2,Saturday
2021-02-20,Students,Students - Residential,1,8,9,11.11,2021,2,Saturday
2021-02-21,Faculty/Staff,Non-Residential,0,35,35,0.0,2021,2,Sunday
2021-02-21,Students,Students - Non-Residential,0,61,61,0.0,2021,2,Sunday
2021-02-21,Students,Students - Residential,0,32,32,0.0,2021,2,Sunday
2021-02-22,Faculty/Staff,Non-Residential,2,156,158,1.27,2021,2,Monday
2021-02-22,Students,Students - Non-Residential,2,1141,1143,0.17,2021,2,Monday
2021-02-22,Students,Students - Residential,0,549,549,0.0,2021,2,Monday
2021-02-23,Faculty/Staff,Non-Residential,2,101,103,1.94,2021,2,Tuesday
2021-02-23,Students,Students - Non-Residential,1,1045,1046,0.1,2021,2,Tuesday
2021-02-23,Students,Students - Residential,1,510,511,0.2,2021,2,Tuesday
2021-02-24,Faculty/Staff,Non-Residential,0,164,164,0.0,2021,2,Wednesday
2021-02-24,Students,Students - Non-Residential,6,1128,1134,0.53,2021,2,Wednesday
2021-02-24,Students,Students - Residential,2,353,355,0.56,2021,2,Wednesday
2021-02-25,Faculty/Staff,Non-Residential,0,61,61,0.0,2021,2,Thursday
2021-02-25,Students,Students - Non-Residential,0,690,690,0.0,2021,2,Thursday
2021-02-25,Students,Students - Residential,1,397,398,0.25,2021,2,Thursday
2021-02-26,Faculty/Staff,Non-Residential,4,102,106,3.77,2021,2,Friday
2021-02-26,Students,Students - Non-Residential,1,486,487,0.21,2021,2,Friday
2021-02-26,Students,Students - Residential,1,243,244,0.41,2021,2,Friday
2021-02-27,Faculty/Staff,Non-Residential,0,2,2,0.0,2021,2,Saturday
2021-02-27,Students,Students - Non-Residential,0,13,13,0.0,2021,2,Saturday
2021-02-27,Students,Students - Residential,0,7,7,0.0,2021,2,Saturday
2021-02-28,Faculty/Staff,Non-Residential,1,14,15,6.67,2021,2,Sunday
2021-02-28,Students,Students - Non-Residential,1,50,51,1.96,2021,2,Sunday
2021-02-28,Students,Students - Residential,0,24,24,0.0,2021,2,Sunday
2021-03-01,Faculty/Staff,Non-Residential,6,158,164,3.66,2021,3,Monday
2021-03-01,Students,Students - Non-Residential,6,1184,1190,0.5,2021,3,Monday
2021-03-01,Students,Students - Residential,2,586,588,0.34,2021,3,Monday
2021-03-02,Faculty/Staff,Non-Residential,2,97,99,2.02,2021,3,Tuesday
2021-03-02,Students,Students - Non-Residential,5,1111,1116,0.45,2021,3,Tuesday
2021-03-02,Students,Students - Residential,2,556,558,0.36,2021,3,Tuesday
2021-03-03,Faculty/Staff,Non-Residential,1,113,114,0.88,2021,3,Wednesday
2021-03-03,Students,Students - Non-Residential,0,329,329,0.0,2021,3,Wednesday
2021-03-03,Students,Students - Residential,0,39,39,0.0,2021,3,Wednesday
2021-03-04,Faculty/Staff,Non-Residential,0,99,99,0.0,2021,3,Thursday
2021-03-04,Students,Students - Non-Residential,7,896,903,0.78,2021,3,Thursday
2021-03-04,Students,Students - Residential,1,533,534,0.19,2021,3,Thursday
2021-03-05,Faculty/Staff,Non-Residential,4,100,104,3.85,2021,3,Friday
2021-03-05,Students,Students - Non-Residential,6,619,625,0.96,2021,3,Friday
2021-03-05,Students,Students - Residential,0,283,283,0.0,2021,3,Friday
2021-03-06,Faculty/Staff,Non-Residential,0,13,13,0.0,2021,3,Saturday
2021-03-06,Students,Students - Non-Residential,1,32,33,3.03,2021,3,Saturday
2021-03-06,Students,Students - Residential,0,13,13,0.0,2021,3,Saturday
2021-03-07,Faculty/Staff,Non-Residential,0,17,17,0.0,2021,3,Sunday
2021-03-07,Students,Students - Non-Residential,1,73,74,1.35,2021,3,Sunday
2021-03-07,Students,Students - Residential,0,15,15,0.0,2021,3,Sunday
2021-03-08,Faculty/Staff,Non-Residential,3,150,153,1.96,2021,3,Monday
2021-03-08,Students,Students - Non-Residential,8,1208,1216,0.66,2021,3,Monday
2021-03-08,Students,Students - Residential,1,612,613,0.16,2021,3,Monday
2021-03-09,Faculty/Staff,Non-Residential,2,94,96,2.08,2021,3,Tuesday
2021-03-09,Students,Students - Non-Residential,6,973,979,0.61,2021,3,Tuesday
2021-03-09,Students,Students - Residential,5,508,513,0.97,2021,3,Tuesday
2021-03-10,Faculty/Staff,Non-Residential,1,140,141,0.71,2021,3,Wednesday
2021-03-10,Students,Students - Non-Residential,8,1036,1044,0.77,2021,3,Wednesday
2021-03-10,Students,Students - Residential,5,407,412,1.21,2021,3,Wednesday
2021-03-11,Faculty/Staff,Non-Residential,0,75,75,0.0,2021,3,Thursday
2021-03-11,Students,Students - Non-Residential,6,670,676,0.89,2021,3,Thursday
2021-03-11,Students,Students - Residential,0,398,398,0.0,2021,3,Thursday
2021-03-12,Faculty/Staff,Non-Residential,0,103,103,0.0,2021,3,Friday
2021-03-12,Students,Students - Non-Residential,4,545,549,0.73,2021,3,Friday
2021-03-12,Students,Students - Residential,0,220,220,0.0,2021,3,Friday
2021-03-13,Faculty/Staff,Non-Residential,0,13,13,0.0,2021,3,Saturday
2021-03-13,Students,Students - Non-Residential,1,39,40,2.5,2021,3,Saturday
2021-03-13,Students,Students - Residential,0,13,13,0.0,2021,3,Saturday
2021-03-14,Faculty/Staff,Non-Residential,0,21,21,0.0,2021,3,Sunday
2021-03-14,Students,Students - Non-Residential,0,43,43,0.0,2021,3,Sunday
2021-03-14,Students,Students - Residential,0,21,21,0.0,2021,3,Sunday
2021-03-15,Faculty/Staff,Non-Residential,2,128,130,1.54,2021,3,Monday
2021-03-15,Students,Students - Non-Residential,6,1185,1191,0.5,2021,3,Monday
2021-03-15,Students,Students - Residential,3,582,585,0.51,2021,3,Monday
2021-03-16,Faculty/Staff,Non-Residential,1,115,116,0.86,2021,3,Tuesday
2021-03-16,Students,Students - Non-Residential,5,1023,1028,0.49,2021,3,Tuesday
2021-03-16,Students,Students - Residential,7,482,489,1.43,2021,3,Tuesday
2021-03-17,Faculty/Staff,Non-Residential,0,134,134,0.0,2021,3,Wednesday
2021-03-17,Students,Students - Non-Residential,2,935,937,0.21,2021,3,Wednesday
2021-03-17,Students,Students - Residential,2,385,387,0.52,2021,3,Wednesday
2021-03-18,Faculty/Staff,Non-Residential,3,75,78,3.85,2021,3,Thursday
2021-03-18,Students,Students - Non-Residential,4,605,609,0.66,2021,3,Thursday
2021-03-18,Students,Students - Residential,3,398,401,0.75,2021,3,Thursday
2021-03-19,Faculty/Staff,Non-Residential,1,58,59,1.69,2021,3,Friday
2021-03-19,Students,Students - Non-Residential,4,443,447,0.89,2021,3,Friday
2021-03-19,Students,Students - Residential,0,202,202,0.0,2021,3,Friday
2021-03-20,Faculty/Staff,Non-Residential,0,36,36,0.0,2021,3,Saturday
2021-03-20,Students,Students - Non-Residential,5,83,88,5.68,2021,3,Saturday
2021-03-20,Students,Students - Residential,1,49,50,2.0,2021,3,Saturday
2021-03-21,Faculty/Staff,Non-Residential,0,17,17,0.0,2021,3,Sunday
2021-03-21,Students,Students - Non-Residential,2,70,72,2.78,2021,3,Sunday
2021-03-21,Students,Students - Residential,0,22,22,0.0,2021,3,Sunday
2021-03-22,Faculty/Staff,Non-Residential,1,113,114,0.88,2021,3,Monday
2021-03-22,Students,Students - Non-Residential,10,1127,1137,0.88,2021,3,Monday
2021-03-22,Students,Students - Residential,5,587,592,0.84,2021,3,Monday
2021-03-23,Faculty/Staff,Non-Residential,3,95,98,3.06,2021,3,Tuesday
2021-03-23,Students,Students - Non-Residential,12,1038,1050,1.14,2021,3,Tuesday
2021-03-23,Students,Students - Residential,13,587,600,2.17,2021,3,Tuesday
2021-03-24,Faculty/Staff,Non-Residential,2,147,149,1.34,2021,3,Wednesday
2021-03-24,Students,Students - Non-Residential,10,965,975,1.03,2021,3,Wednesday
2021-03-24,Students,Students - Residential,12,362,374,3.21,2021,3,Wednesday
2021-03-25,Faculty/Staff,Non-Residential,2,61,63,3.17,2021,3,Thursday
2021-03-25,Students,Students - Non-Residential,10,625,635,1.57,2021,3,Thursday
2021-03-25,Students,Students - Residential,9,361,370,2.43,2021,3,Thursday
2021-03-26,Faculty/Staff,Non-Residential,3,74,77,3.9,2021,3,Friday
2021-03-26,Students,Students - Non-Residential,3,518,521,0.58,2021,3,Friday
2021-03-26,Students,Students - Residential,5,239,244,2.05,2021,3,Friday
2021-03-27,Faculty/Staff,Non-Residential,0,39,39,0.0,2021,3,Saturday
2021-03-27,Students,Students - Non-Residential,4,95,99,4.04,2021,3,Saturday
2021-03-27,Students,Students - Residential,4,64,68,5.88,2021,3,Saturday
2021-03-28,Faculty/Staff,Non-Residential,0,21,21,0.0,2021,3,Sunday
2021-03-28,Students,Students - Non-Residential,2,75,77,2.6,2021,3,Sunday
2021-03-28,Students,Students - Residential,0,20,20,0.0,2021,3,Sunday
2021-03-29,Faculty/Staff,Non-Residential,6,91,97,6.19,2021,3,Monday
2021-03-29,Students,Students - Non-Residential,11,1078,1089,1.01,2021,3,Monday
2021-03-29,Students,Students - Residential,17,550,567,3.0,2021,3,Monday
2021-03-30,Faculty/Staff,Non-Residential,1,121,122,0.82,2021,3,Tuesday
2021-03-30,Students,Students - Non-Residential,10,1009,1019,0.98,2021,3,Tuesday
2021-03-30,Students,Students - Residential,19,561,580,3.28,2021,3,Tuesday
2021-03-31,Faculty/Staff,Non-Residential,2,150,152,1.32,2021,3,Wednesday
2021-03-31,Students,Students - Non-Residential,13,908,921,1.41,2021,3,Wednesday
2021-03-31,Students,Students - Residential,11,346,357,3.08,2021,3,Wednesday
2021-04-01,Faculty/Staff,Non-Residential,5,69,74,6.76,2021,4,Thursday
2021-04-01,Students,Students - Non-Residential,9,637,646,1.39,2021,4,Thursday
2021-04-01,Students,Students - Residential,7,339,346,2.02,2021,4,Thursday
2021-04-02,Faculty/Staff,Non-Residential,4,85,89,4.49,2021,4,Friday
2021-04-02,Students,Students - Non-Residential,4,571,575,0.7,2021,4,Friday
2021-04-02,Students,Students - Residential,7,214,221,3.17,2021,4,Friday
2021-04-03,Students,Students - Non-Residential,0,25,25,0.0,2021,4,Saturday
2021-04-03,Students,Students - Residential,2,13,15,13.33,2021,4,Saturday
2021-04-04,Faculty/Staff,Non-Residential,0,15,15,0.0,2021,4,Sunday
2021-04-04,Students,Students - Non-Residential,4,42,46,8.7,2021,4,Sunday
2021-04-04,Students,Students - Residential,4,21,25,16.0,2021,4,Sunday
2021-04-05,Faculty/Staff,Non-Residential,2,167,169,1.18,2021,4,Monday
2021-04-05,Students,Students - Non-Residential,9,1101,1110,0.81,2021,4,Monday
2021-04-05,Students,Students - Residential,10,520,530,1.89,2021,4,Monday
2021-04-06,Faculty/Staff,Non-Residential,1,107,108,0.93,2021,4,Tuesday
2021-04-06,Students,Students - Non-Residential,17,916,933,1.82,2021,4,Tuesday
2021-04-06,Students,Students - Residential,5,527,532,0.94,2021,4,Tuesday
2021-04-07,Faculty/Staff,Non-Residential,4,140,144,2.78,2021,4,Wednesday
2021-04-07,Students,Students - Non-Residential,9,856,865,1.04,2021,4,Wednesday
2021-04-07,Students,Students - Residential,10,314,324,3.09,2021,4,Wednesday
2021-04-08,Faculty/Staff,Non-Residential,3,53,56,5.36,2021,4,Thursday
2021-04-08,Students,Students - Non-Residential,7,600,607,1.15,2021,4,Thursday
2021-04-08,Students,Students - Residential,6,370,376,1.6,2021,4,Thursday
2021-04-09,Faculty/Staff,Non-Residential,0,56,56,0.0,2021,4,Friday
2021-04-09,Students,Students - Non-Residential,5,434,439,1.14,2021,4,Friday
2021-04-09,Students,Students - Residential,3,201,204,1.47,2021,4,Friday
2021-04-10,Faculty/Staff,Non-Residential,1,35,36,2.78,2021,4,Saturday
2021-04-10,Students,Students - Non-Residential,2,93,95,2.11,2021,4,Saturday
2021-04-10,Students,Students - Residential,1,53,54,1.85,2021,4,Saturday
2021-04-11,Faculty/Staff,Non-Residential,0,13,13,0.0,2021,4,Sunday
2021-04-11,Students,Students - Non-Residential,1,42,43,2.33,2021,4,Sunday
2021-04-11,Students,Students - Residential,0,17,17,0.0,2021,4,Sunday
2021-04-12,Faculty/Staff,Non-Residential,1,123,124,0.81,2021,4,Monday
2021-04-12,Students,Students - Non-Residential,3,1196,1199,0.25,2021,4,Monday
2021-04-12,Students,Students - Residential,6,508,514,1.17,2021,4,Monday
2021-04-13,Faculty/Staff,Non-Residential,2,103,105,1.9,2021,4,Tuesday
2021-04-13,Students,Students - Non-Residential,5,871,876,0.57,2021,4,Tuesday
2021-04-13,Students,Students - Residential,3,481,484,0.62,2021,4,Tuesday
2021-04-14,Faculty/Staff,Non-Residential,1,134,135,0.74,2021,4,Wednesday
2021-04-14,Students,Students - Non-Residential,1,290,291,0.34,2021,4,Wednesday
2021-04-14,Students,Students - Residential,1,35,36,2.78,2021,4,Wednesday
2021-04-15,Faculty/Staff,Non-Residential,3,97,100,3.0,2021,4,Thursday
2021-04-15,Students,Students - Non-Residential,5,771,776,0.64,2021,4,Thursday
2021-04-15,Students,Students - Residential,3,505,508,0.59,2021,4,Thursday
2021-04-16,Faculty/Staff,Non-Residential,0,63,63,0.0,2021,4,Friday
2021-04-16,Students,Students - Non-Residential,5,449,454,1.1,2021,4,Friday
2021-04-16,Students,Students - Residential,3,191,194,1.55,2021,4,Friday
2021-04-17,Faculty/Staff,Non-Residential,0,2,2,0.0,2021,4,Saturday
2021-04-17,Students,Students - Non-Residential,0,8,8,0.0,2021,4,Saturday
2021-04-17,Students,Students - Residential,1,10,11,9.09,2021,4,Saturday
2021-04-18,Faculty/Staff,Non-Residential,0,11,11,0.0,2021,4,Sunday
2021-04-18,Students,Students - Non-Residential,2,39,41,4.88,2021,4,Sunday
2021-04-18,Students,Students - Residential,1,7,8,12.5,2021,4,Sunday
2021-04-19,Faculty/Staff,Non-Residential,3,102,105,2.86,2021,4,Monday
2021-04-19,Students,Students - Non-Residential,5,981,986,0.51,2021,4,Monday
2021-04-19,Students,Students - Residential,8,487,495,1.62,2021,4,Monday
2021-04-20,Faculty/Staff,Non-Residential,3,93,96,3.12,2021,4,Tuesday
2021-04-20,Students,Students - Non-Residential,10,805,815,1.23,2021,4,Tuesday
2021-04-20,Students,Students - Residential,7,392,399,1.75,2021,4,Tuesday
2021-04-21,Faculty/Staff,Non-Residential,1,159,160,0.62,2021,4,Wednesday
2021-04-21,Students,Students - Non-Residential,6,768,774,0.78,2021,4,Wednesday
2021-04-21,Students,Students - Residential,4,332,336,1.19,2021,4,Wednesday
2021-04-22,Faculty/Staff,Non-Residential,2,63,65,3.08,2021,4,Thursday
2021-04-22,Students,Students - Non-Residential,5,516,521,0.96,2021,4,Thursday
2021-04-22,Students,Students - Residential,5,298,303,1.65,2021,4,Thursday
2021-04-23,Faculty/Staff,Non-Residential,0,40,40,0.0,2021,4,Friday
2021-04-23,Students,Students - Non-Residential,3,362,365,0.82,2021,4,Friday
2021-04-23,Students,Students - Residential,4,150,154,2.6,2021,4,Friday
2021-04-24,Faculty/Staff,Non-Residential,0,4,4,0.0,2021,4,Saturday
2021-04-24,Students,Students - Non-Residential,0,12,12,0.0,2021,4,Saturday
2021-04-24,Students,Students - Residential,0,7,7,0.0,2021,4,Saturday
2021-04-25,Faculty/Staff,Non-Residential,0,16,16,0.0,2021,4,Sunday
2021-04-25,Students,Students - Non-Residential,0,63,63,0.0,2021,4,Sunday
2021-04-25,Students,Students - Residential,0,34,34,0.0,2021,4,Sunday
2021-04-26,Faculty/Staff,Non-Residential,6,124,130,4.62,2021,4,Monday
2021-04-26,Students,Students - Non-Residential,5,1041,1046,0.48,2021,4,Monday
2021-04-26,Students,Students - Residential,5,485,490,1.02,2021,4,Monday
2021-04-27,Faculty/Staff,Non-Residential,2,91,93,2.15,2021,4,Tuesday
2021-04-27,Students,Students - Non-Residential,3,688,691,0.43,2021,4,Tuesday
2021-04-27,Students,Students - Residential,2,387,389,0.51,2021,4,Tuesday
2021-04-28,Faculty/Staff,Non-Residential,1,152,153,0.65,2021,4,Wednesday
2021-04-28,Students,Students - Non-Residential,5,603,608,0.82,2021,4,Wednesday
2021-04-28,Students,Students - Residential,2,298,300,0.67,2021,4,Wednesday
2021-04-29,Faculty/Staff,Non-Residential,6,45,51,11.76,2021,4,Thursday
2021-04-29,Students,Students - Non-Residential,4,378,382,1.05,2021,4,Thursday
2021-04-29,Students,Students - Residential,1,263,264,0.38,2021,4,Thursday
2021-04-30,Faculty/Staff,Non-Residential,4,47,51,7.84,2021,4,Friday
2021-04-30,Students,Students - Non-Residential,1,316,317,0.32,2021,4,Friday
2021-04-30,Students,Students - Residential,2,137,139,1.44,2021,4,Friday
2021-05-01,Faculty/Staff,Non-Residential,1,9,10,10.0,2021,5,Saturday
2021-05-01,Students,Students - Non-Residential,2,39,41,4.88,2021,5,Saturday
2021-05-01,Students,Students - Residential,0,19,19,0.0,2021,5,Saturday
2021-05-02,Faculty/Staff,Non-Residential,0,10,10,0.0,2021,5,Sunday
2021-05-02,Students,Students - Non-Residential,1,45,46,2.17,2021,5,Sunday
2021-05-02,Students,Students - Residential,0,12,12,0.0,2021,5,Sunday
2021-05-03,Faculty/Staff,Non-Residential,2,102,104,1.92,2021,5,Monday
2021-05-03,Students,Students - Non-Residential,1,418,419,0.24,2021,5,Monday
2021-05-03,Students,Students - Residential,0,107,107,0.0,2021,5,Monday
2021-05-04,Faculty/Staff,Non-Residential,1,49,50,2.0,2021,5,Tuesday
2021-05-04,Students,Students - Non-Residential,0,177,177,0.0,2021,5,Tuesday
2021-05-04,Students,Students - Residential,0,82,82,0.0,2021,5,Tuesday
2021-05-05,Faculty/Staff,Non-Residential,2,134,136,1.47,2021,5,Wednesday
2021-05-05,Students,Students - Non-Residential,1,288,289,0.35,2021,5,Wednesday
2021-05-05,Students,Students - Residential,0,85,85,0.0,2021,5,Wednesday
2021-05-06,Faculty/Staff,Non-Residential,4,26,30,13.33,2021,5,Thursday
2021-05-06,Students,Students - Non-Residential,1,134,135,0.74,2021,5,Thursday
2021-05-06,Students,Students - Residential,0,58,58,0.0,2021,5,Thursday
2021-05-07,Faculty/Staff,Non-Residential,0,45,45,0.0,2021,5,Friday
2021-05-07,Students,Students - Non-Residential,1,180,181,0.55,2021,5,Friday
2021-05-07,Students,Students - Residential,0,34,34,0.0,2021,5,Friday
2021-05-08,Faculty/Staff,Non-Residential,0,1,1,0.0,2021,5,Saturday
2021-05-08,Students,Students - Non-Residential,0,5,5,0.0,2021,5,Saturday
2021-05-08,Students,Students - Residential,0,2,2,0.0,2021,5,Saturday
2021-05-09,Faculty/Staff,Non-Residential,0,0,0,,2021,5,Sunday
2021-05-09,Students,Students - Non-Residential,0,13,13,0.0,2021,5,Sunday
2021-05-09,Students,Students - Residential,0,9,9,0.0,2021,5,Sunday
2021-05-10,Faculty/Staff,Non-Residential,1,129,130,0.77,2021,5,Monday
2021-05-10,Students,Students - Non-Residential,0,294,294,0.0,2021,5,Monday
2021-05-10,Students,Students - Residential,0,58,58,0.0,2021,5,Monday
2021-05-11,Faculty/Staff,Non-Residential,2,127,129,1.55,2021,5,Tuesday
2021-05-11,Students,Students - Non-Residential,0,214,214,0.0,2021,5,Tuesday
2021-05-11,Students,Students - Residential,0,60,60,0.0,2021,5,Tuesday
2021-05-12,Faculty/Staff,Non-Residential,1,151,152,0.66,2021,5,Wednesday
2021-05-12,Students,Students - Non-Residential,0,351,351,0.0,2021,5,Wednesday
2021-05-12,Students,Students - Residential,1,51,52,1.92,2021,5,Wednesday
2021-05-13,Faculty/Staff,Non-Residential,0,34,34,0.0,2021,5,Thursday
2021-05-13,Students,Students - Non-Residential,1,89,90,1.11,2021,5,Thursday
2021-05-13,Students,Students - Residential,0,42,42,0.0,2021,5,Thursday
2021-05-14,Faculty/Staff,Non-Residential,0,46,46,0.0,2021,5,Friday
2021-05-14,Students,Students - Non-Residential,0,115,115,0.0,2021,5,Friday
2021-05-14,Students,Students - Residential,0,15,15,0.0,2021,5,Friday
2021-05-15,Faculty/Staff,Non-Residential,0,2,2,0.0,2021,5,Saturday
2021-05-15,Students,Students - Non-Residential,0,13,13,0.0,2021,5,Saturday
2021-05-15,Students,Students - Residential,0,1,1,0.0,2021,5,Saturday
2021-05-16,Faculty/Staff,Non-Residential,0,32,32,0.0,2021,5,Sunday
2021-05-16,Students,Students - Non-Residential,0,85,85,0.0,2021,5,Sunday
2021-05-16,Students,Students - Residential,0,37,37,0.0,2021,5,Sunday
2021-05-17,Faculty/Staff,Non-Residential,4,120,124,3.23,2021,5,Monday
2021-05-17,Students,Students - Non-Residential,2,158,160,1.25,2021,5,Monday
2021-05-17,Students,Students - Residential,0,43,43,0.0,2021,5,Monday
2021-05-18,Faculty/Staff,Non-Residential,2,66,68,2.94,2021,5,Tuesday
2021-05-18,Students,Students - Non-Residential,0,137,137,0.0,2021,5,Tuesday
2021-05-18,Students,Students - Residential,0,11,11,0.0,2021,5,Tuesday
2021-05-19,Faculty/Staff,Non-Residential,2,89,91,2.2,2021,5,Wednesday
2021-05-19,Students,Students - Non-Residential,1,169,170,0.59,2021,5,Wednesday
2021-05-19,Students,Students - Residential,0,2,2,0.0,2021,5,Wednesday
2021-05-20,Faculty/Staff,Non-Residential,1,30,31,3.23,2021,5,Thursday
2021-05-20,Students,Students - Non-Residential,0,131,131,0.0,2021,5,Thursday
2021-05-20,Students,Students - Residential,0,4,4,0.0,2021,5,Thursday
2021-05-21,Faculty/Staff,Non-Residential,0,45,45,0.0,2021,5,Friday
2021-05-21,Students,Students - Non-Residential,1,54,55,1.82,2021,5,Friday
2021-05-21,Students,Students - Residential,0,43,43,0.0,2021,5,Friday
2021-05-22,Faculty/Staff,Non-Residential,0,1,1,0.0,2021,5,Saturday
2021-05-22,Students,Students - Non-Residential,0,3,3,0.0,2021,5,Saturday
2021-05-23,Faculty/Staff,Non-Residential,0,14,14,0.0,2021,5,Sunday
2021-05-23,Students,Students - Non-Residential,0,18,18,0.0,2021,5,Sunday
2021-05-23,Students,Students - Residential,0,13,13,0.0,2021,5,Sunday
2021-05-24,Faculty/Staff,Non-Residential,2,92,94,2.13,2021,5,Monday
2021-05-24,Students,Students - Non-Residential,1,92,93,1.08,2021,5,Monday
2021-05-24,Students,Students - Residential,0,46,46,0.0,2021,5,Monday
2021-05-25,Faculty/Staff,Non-Residential,0,62,62,0.0,2021,5,Tuesday
2021-05-25,Students,Students - Non-Residential,0,121,121,0.0,2021,5,Tuesday
2021-05-25,Students,Students - Residential,1,19,20,5.0,2021,5,Tuesday
2021-05-26,Faculty/Staff,Non-Residential,2,97,99,2.02,2021,5,Wednesday
2021-05-26,Students,Students - Non-Residential,1,59,60,1.67,2021,5,Wednesday
2021-05-26,Students,Students - Residential,0,4,4,0.0,2021,5,Wednesday
2021-05-27,Faculty/Staff,Non-Residential,0,20,20,0.0,2021,5,Thursday
2021-05-27,Students,Students - Non-Residential,0,67,67,0.0,2021,5,Thursday
2021-05-27,Students,Students - Residential,0,5,5,0.0,2021,5,Thursday
2021-05-28,Faculty/Staff,Non-Residential,0,31,31,0.0,2021,5,Friday
2021-05-28,Students,Students - Non-Residential,0,10,10,0.0,2021,5,Friday
2021-05-28,Students,Students - Residential,0,1,1,0.0,2021,5,Friday
2021-05-29,Faculty/Staff,Non-Residential,0,1,1,0.0,2021,5,Saturday
2021-05-29,Students,Students - Non-Residential,0,2,2,0.0,2021,5,Saturday
2021-05-30,Faculty/Staff,Non-Residential,0,4,4,0.0,2021,5,Sunday
2021-05-30,Students,Students - Non-Residential,0,17,17,0.0,2021,5,Sunday
2021-05-30,Students,Students - Residential,0,9,9,0.0,2021,5,Sunday
2021-05-31,Faculty/Staff,Non-Residential,0,1,1,0.0,2021,5,Monday
2021-05-31,Students,Students - Non-Residential,0,0,0,,2021,5,Monday
2021-06-01,Faculty/Staff,Non-Residential,0,57,57,0.0,2021,6,Tuesday
2021-06-01,Students,Students - Non-Residential,0,156,156,0.0,2021,6,Tuesday
2021-06-01,Students,Students - Residential,0,51,51,0.0,2021,6,Tuesday
2021-06-02,Faculty/Staff,Non-Residential,0,29,29,0.0,2021,6,Wednesday
2021-06-02,Students,Students - Non-Residential,0,56,56,0.0,2021,6,Wednesday
2021-06-02,Students,Students - Residential,0,14,14,0.0,2021,6,Wednesday
2021-06-03,Faculty/Staff,Non-Residential,1,22,23,4.35,2021,6,Thursday
2021-06-03,Students,Students - Non-Residential,0,119,119,0.0,2021,6,Thursday
2021-06-03,Students,Students - Residential,0,49,49,0.0,2021,6,Thursday
2021-06-04,Faculty/Staff,Non-Residential,0,32,32,0.0,2021,6,Friday
2021-06-04,Students,Students - Non-Residential,0,28,28,0.0,2021,6,Friday
2021-06-04,Students,Students - Residential,0,10,10,0.0,2021,6,Friday
2021-06-05,Faculty/Staff,Non-Residential,0,4,4,0.0,2021,6,Saturday
2021-06-05,Students,Students - Non-Residential,0,6,6,0.0,2021,6,Saturday
2021-06-05,Students,Students - Residential,0,4,4,0.0,2021,6,Saturday
2021-06-06,Students,Students - Non-Residential,0,1,1,0.0,2021,6,Sunday
2021-06-07,Faculty/Staff,Non-Residential,1,33,34,2.94,2021,6,Monday
2021-06-07,Students,Students - Non-Residential,1,38,39,2.56,2021,6,Monday
2021-06-07,Students,Students - Residential,0,9,9,0.0,2021,6,Monday
2021-06-08,Faculty/Staff,Non-Residential,0,35,35,0.0,2021,6,Tuesday
2021-06-08,Students,Students - Non-Residential,0,133,133,0.0,2021,6,Tuesday
2021-06-08,Students,Students - Residential,0,48,48,0.0,2021,6,Tuesday
2021-06-09,Faculty/Staff,Non-Residential,0,32,32,0.0,2021,6,Wednesday
2021-06-09,Students,Students - Non-Residential,0,58,58,0.0,2021,6,Wednesday
2021-06-09,Students,Students - Residential,0,8,8,0.0,2021,6,Wednesday
2021-06-10,Faculty/Staff,Non-Residential,0,12,12,0.0,2021,6,Thursday
2021-06-10,Students,Students - Non-Residential,0,90,90,0.0,2021,6,Thursday
2021-06-10,Students,Students - Residential,0,41,41,0.0,2021,6,Thursday
2021-06-11,Faculty/Staff,Non-Residential,1,27,28,3.57,2021,6,Friday
2021-06-11,Students,Students - Non-Residential,0,18,18,0.0,2021,6,Friday
2021-06-11,Students,Students - Residential,0,4,4,0.0,2021,6,Friday
2021-06-12,Students,Students - Non-Residential,0,1,1,0.0,2021,6,Saturday
2021-06-13,Faculty/Staff,Non-Residential,1,0,1,100.0,2021,6,Sunday
2021-06-14,Faculty/Staff,Non-Residential,0,31,31,0.0,2021,6,Monday
2021-06-14,Students,Students - Non-Residential,0,46,46,0.0,2021,6,Monday
2021-06-14,Students,Students - Residential,0,15,15,0.0,2021,6,Monday
2021-06-15,Faculty/Staff,Non-Residential,0,25,25,0.0,2021,6,Tuesday
2021-06-15,Students,Students - Non-Residential,0,107,107,0.0,2021,6,Tuesday
2021-06-15,Students,Students - Residential,0,53,53,0.0,2021,6,Tuesday
2021-06-16,Faculty/Staff,Non-Residential,3,20,23,13.04,2021,6,Wednesday
2021-06-16,Students,Students - Non-Residential,2,59,61,3.28,2021,6,Wednesday
2021-06-16,Students,Students - Residential,0,11,11,0.0,2021,6,Wednesday
2021-06-17,Faculty/Staff,Non-Residential,0,10,10,0.0,2021,6,Thursday
2021-06-17,Students,Students - Non-Residential,0,88,88,0.0,2021,6,Thursday
2021-06-17,Students,Students - Residential,0,51,51,0.0,2021,6,Thursday
2021-06-18,Faculty/Staff,Non-Residential,1,20,21,4.76,2021,6,Friday
2021-06-18,Students,Students - Non-Residential,1,13,14,7.14,2021,6,Friday
2021-06-18,Students,Students - Residential,0,2,2,0.0,2021,6,Friday
2021-06-19,Faculty/Staff,Non-Residential,0,1,1,0.0,2021,6,Saturday
2021-06-19,Students,Students - Non-Residential,0,3,3,0.0,2021,6,Saturday
2021-06-20,Faculty/Staff,Non-Residential,0,1,1,0.0,2021,6,Sunday
2021-06-20,Students,Students - Non-Residential,0,1,1,0.0,2021,6,Sunday
2021-06-20,Students,Students - Residential,0,2,2,0.0,2021,6,Sunday
2021-06-21,Faculty/Staff,Non-Residential,1,22,23,4.35,2021,6,Monday
2021-06-21,Students,Students - Non-Residential,0,43,43,0.0,2021,6,Monday
2021-06-21,Students,Students - Residential,0,15,15,0.0,2021,6,Monday
2021-06-22,Faculty/Staff,Non-Residential,3,17,20,15.0,2021,6,Tuesday
2021-06-22,Students,Students - Non-Residential,0,118,118,0.0,2021,6,Tuesday
2021-06-22,Students,Students - Residential,0,47,47,0.0,2021,6,Tuesday
2021-06-23,Faculty/Staff,Non-Residential,2,20,22,9.09,2021,6,Wednesday
2021-06-23,Students,Students - Non-Residential,1,77,78,1.28,2021,6,Wednesday
2021-06-23,Students,Students - Residential,0,19,19,0.0,2021,6,Wednesday
2021-06-24,Faculty/Staff,Non-Residential,1,18,19,5.26,2021,6,Thursday
2021-06-24,Students,Students - Non-Residential,0,98,98,0.0,2021,6,Thursday
2021-06-24,Students,Students - Residential,0,52,52,0.0,2021,6,Thursday
2021-06-25,Faculty/Staff,Non-Residential,4,24,28,14.29,2021,6,Friday
2021-06-25,Students,Students - Non-Residential,1,8,9,11.11,2021,6,Friday
2021-06-25,Students,Students - Residential,0,0,0,,2021,6,Friday
2021-06-26,Faculty/Staff,Non-Residential,0,1,1,0.0,2021,6,Saturday
2021-06-26,Students,Students - Non-Residential,0,1,1,0.0,2021,6,Saturday
2021-06-27,Students,Students - Non-Residential,0,7,7,0.0,2021,6,Sunday
2021-06-27,Students,Students - Residential,0,4,4,0.0,2021,6,Sunday
2021-06-28,Faculty/Staff,Non-Residential,0,17,17,0.0,2021,6,Monday
2021-06-28,Students,Students - Non-Residential,0,36,36,0.0,2021,6,Monday
2021-06-28,Students,Students - Residential,0,11,11,0.0,2021,6,Monday
2021-06-29,Faculty/Staff,Non-Residential,2,29,31,6.45,2021,6,Tuesday
2021-06-29,Students,Students - Non-Residential,0,118,118,0.0,2021,6,Tuesday
2021-06-29,Students,Students - Residential,0,42,42,0.0,2021,6,Tuesday
2021-06-30,Faculty/Staff,Non-Residential,3,17,20,15.0,2021,6,Wednesday
2021-06-30,Students,Students - Non-Residential,1,91,92,1.09,2021,6,Wednesday
2021-06-30,Students,Students - Residential,0,21,21,0.0,2021,6,Wednesday
2021-07-01,Faculty/Staff,Non-Residential,1,23,24,4.17,2021,7,Thursday
2021-07-01,Students,Students - Non-Residential,0,79,79,0.0,2021,7,Thursday
2021-07-01,Students,Students - Residential,0,48,48,0.0,2021,7,Thursday
2021-07-02,Faculty/Staff,Non-Residential,0,19,19,0.0,2021,7,Friday
2021-07-02,Students,Students - Non-Residential,1,5,6,16.67,2021,7,Friday
2021-07-04,Faculty/Staff,Non-Residential,0,2,2,0.0,2021,7,Sunday
2021-07-05,Faculty/Staff,Non-Residential,0,4,4,0.0,2021,7,Monday
2021-07-05,Students,Students - Non-Residential,0,2,2,0.0,2021,7,Monday
2021-07-06,Faculty/Staff,Non-Residential,4,33,37,10.81,2021,7,Tuesday
2021-07-06,Students,Students - Non-Residential,1,20,21,4.76,2021,7,Tuesday
2021-07-06,Students,Students - Residential,1,18,19,5.26,2021,7,Tuesday
2021-07-07,Faculty/Staff,Non-Residential,2,36,38,5.26,2021,7,Wednesday
2021-07-07,Students,Students - Non-Residential,1,96,97,1.03,2021,7,Wednesday
2021-07-07,Students,Students - Residential,0,20,20,0.0,2021,7,Wednesday
2021-07-08,Faculty/Staff,Non-Residential,1,35,36,2.78,2021,7,Thursday
2021-07-08,Students,Students - Non-Residential,1,66,67,1.49,2021,7,Thursday
2021-07-08,Students,Students - Residential,0,33,33,0.0,2021,7,Thursday
2021-07-09,Faculty/Staff,Non-Residential,1,23,24,4.17,2021,7,Friday
2021-07-09,Students,Students - Non-Residential,0,35,35,0.0,2021,7,Friday
2021-07-09,Students,Students - Residential,0,14,14,0.0,2021,7,Friday
2021-07-10,Faculty/Staff,Non-Residential,0,0,0,,2021,7,Saturday
2021-07-10,Students,Students - Non-Residential,0,1,1,0.0,2021,7,Saturday
2021-07-11,Faculty/Staff,Non-Residential,0,1,1,0.0,2021,7,Sunday
2021-07-11,Students,Students - Non-Residential,0,1,1,0.0,2021,7,Sunday
2021-07-12,Faculty/Staff,Non-Residential,3,34,37,8.11,2021,7,Monday
2021-07-12,Students,Students - Non-Residential,0,38,38,0.0,2021,7,Monday
2021-07-12,Students,Students - Residential,0,16,16,0.0,2021,7,Monday
2021-07-13,Faculty/Staff,Non-Residential,3,33,36,8.33,2021,7,Tuesday
2021-07-13,Students,Students - Non-Residential,1,89,90,1.11,2021,7,Tuesday
2021-07-13,Students,Students - Residential,0,38,38,0.0,2021,7,Tuesday
2021-07-14,Faculty/Staff,Non-Residential,5,26,31,16.13,2021,7,Wednesday
2021-07-14,Students,Students - Non-Residential,0,88,88,0.0,2021,7,Wednesday
2021-07-14,Students,Students - Residential,0,23,23,0.0,2021,7,Wednesday
2021-07-15,Faculty/Staff,Non-Residential,1,34,35,2.86,2021,7,Thursday
2021-07-15,Students,Students - Non-Residential,0,75,75,0.0,2021,7,Thursday
2021-07-15,Students,Students - Residential,0,37,37,0.0,2021,7,Thursday
2021-07-16,Faculty/Staff,Non-Residential,5,32,37,13.51,2021,7,Friday
2021-07-16,Students,Students - Non-Residential,0,27,27,0.0,2021,7,Friday
2021-07-16,Students,Students - Residential,0,6,6,0.0,2021,7,Friday
2021-07-17,Faculty/Staff,Non-Residential,0,5,5,0.0,2021,7,Saturday
2021-07-17,Students,Students - Non-Residential,0,3,3,0.0,2021,7,Saturday
2021-07-18,Faculty/Staff,Non-Residential,0,2,2,0.0,2021,7,Sunday
2021-07-19,Faculty/Staff,Non-Residential,5,53,58,8.62,2021,7,Monday
2021-07-19,Students,Students - Non-Residential,1,50,51,1.96,2021,7,Monday
2021-07-19,Students,Students - Residential,0,19,19,0.0,2021,7,Monday
2021-07-20,Faculty/Staff,Non-Residential,9,50,59,15.25,2021,7,Tuesday
2021-07-20,Students,Students - Non-Residential,2,94,96,2.08,2021,7,Tuesday
2021-07-20,Students,Students - Residential,0,34,34,0.0,2021,7,Tuesday
2021-07-21,Faculty/Staff,Non-Residential,7,43,50,14.0,2021,7,Wednesday
2021-07-21,Students,Students - Non-Residential,0,87,87,0.0,2021,7,Wednesday
2021-07-21,Students,Students - Residential,0,28,28,0.0,2021,7,Wednesday
2021-07-22,Faculty/Staff,Non-Residential,11,46,57,19.3,2021,7,Thursday
2021-07-22,Students,Students - Non-Residential,2,73,75,2.67,2021,7,Thursday
2021-07-22,Students,Students - Residential,0,55,55,0.0,2021,7,Thursday
2021-07-23,Faculty/Staff,Non-Residential,5,47,52,9.62,2021,7,Friday
2021-07-23,Students,Students - Non-Residential,0,26,26,0.0,2021,7,Friday
2021-07-23,Students,Students - Residential,0,50,50,0.0,2021,7,Friday
2021-07-24,Faculty/Staff,Non-Residential,0,4,4,0.0,2021,7,Saturday
2021-07-24,Students,Students - Non-Residential,0,5,5,0.0,2021,7,Saturday
2021-07-24,Students,Students - Residential,0,1,1,0.0,2021,7,Saturday
2021-07-25,Faculty/Staff,Non-Residential,1,2,3,33.33,2021,7,Sunday
2021-07-25,Students,Students - Non-Residential,0,1,1,0.0,2021,7,Sunday
2021-07-26,Faculty/Staff,Non-Residential,17,46,63,26.98,2021,7,Monday
2021-07-26,Students,Students - Non-Residential,0,48,48,0.0,2021,7,Monday
2021-07-26,Students,Students - Residential,1,20,21,4.76,2021,7,Monday
2021-07-27,Faculty/Staff,Non-Residential,9,69,78,11.54,2021,7,Tuesday
2021-07-27,Students,Students - Non-Residential,4,80,84,4.76,2021,7,Tuesday
2021-07-27,Students,Students - Residential,1,30,31,3.23,2021,7,Tuesday
2021-07-28,Faculty/Staff,Non-Residential,11,66,77,14.29,2021,7,Wednesday
2021-07-28,Students,Students - Non-Residential,3,82,85,3.53,2021,7,Wednesday
2021-07-28,Students,Students - Residential,1,19,20,5.0,2021,7,Wednesday
2021-07-29,Faculty/Staff,Non-Residential,4,50,54,7.41,2021,7,Thursday
2021-07-29,Students,Students - Non-Residential,3,62,65,4.62,2021,7,Thursday
2021-07-29,Students,Students - Residential,0,24,24,0.0,2021,7,Thursday
2021-07-30,Faculty/Staff,Non-Residential,5,48,53,9.43,2021,7,Friday
2021-07-30,Students,Students - Non-Residential,0,16,16,0.0,2021,7,Friday
2021-07-30,Students,Students - Residential,1,2,3,33.33,2021,7,Friday
2021-07-31,Faculty/Staff,Non-Residential,2,6,8,25.0,2021,7,Saturday
2021-07-31,Students,Students - Non-Residential,0,3,3,0.0,2021,7,Saturday
2021-08-01,Faculty/Staff,Non-Residential,0,4,4,0.0,2021,8,Sunday
2021-08-01,Students,Students - Non-Residential,0,1,1,0.0,2021,8,Sunday
2021-08-02,Faculty/Staff,Non-Residential,7,75,82,8.54,2021,8,Monday
2021-08-02,Students,Students - Non-Residential,5,45,50,10.0,2021,8,Monday
2021-08-02,Students,Students - Residential,1,12,13,7.69,2021,8,Monday
2021-08-03,Faculty/Staff,Non-Residential,16,97,113,14.16,2021,8,Tuesday
2021-08-03,Students,Students - Non-Residential,2,69,71,2.82,2021,8,Tuesday
2021-08-03,Students,Students - Residential,0,19,19,0.0,2021,8,Tuesday
2021-08-04,Faculty/Staff,Non-Residential,6,66,72,8.33,2021,8,Wednesday
2021-08-04,Students,Students - Non-Residential,3,73,76,3.95,2021,8,Wednesday
2021-08-04,Students,Students - Residential,1,13,14,7.14,2021,8,Wednesday
2021-08-05,Faculty/Staff,Non-Residential,6,73,79,7.59,2021,8,Thursday
2021-08-05,Students,Students - Non-Residential,1,74,75,1.33,2021,8,Thursday
2021-08-05,Students,Students - Residential,1,23,24,4.17,2021,8,Thursday
2021-08-06,Faculty/Staff,Non-Residential,10,74,84,11.9,2021,8,Friday
2021-08-06,Students,Students - Non-Residential,1,21,22,4.55,2021,8,Friday
2021-08-06,Students,Students - Residential,0,2,2,0.0,2021,8,Friday
2021-08-07,Faculty/Staff,Non-Residential,1,6,7,14.29,2021,8,Saturday
2021-08-07,Students,Students - Non-Residential,0,13,13,0.0,2021,8,Saturday
2021-08-07,Students,Students - Residential,0,86,86,0.0,2021,8,Saturday
2021-08-08,Faculty/Staff,Non-Residential,3,9,12,25.0,2021,8,Sunday
2021-08-08,Students,Students - Non-Residential,0,20,20,0.0,2021,8,Sunday
2021-08-08,Students,Students - Residential,1,73,74,1.35,2021,8,Sunday
2021-08-09,Faculty/Staff,Non-Residential,9,104,113,7.96,2021,8,Monday
2021-08-09,Students,Students - Non-Residential,1,71,72,1.39,2021,8,Monday
2021-08-09,Students,Students - Residential,0,94,94,0.0,2021,8,Monday
2021-08-10,Faculty/Staff,Non-Residential,16,82,98,16.33,2021,8,Tuesday
2021-08-10,Students,Students - Non-Residential,3,49,52,5.77,2021,8,Tuesday
2021-08-10,Students,Students - Residential,0,33,33,0.0,2021,8,Tuesday
2021-08-11,Faculty/Staff,Non-Residential,6,85,91,6.59,2021,8,Wednesday
2021-08-11,Students,Students - Non-Residential,4,78,82,4.88,2021,8,Wednesday
2021-08-11,Students,Students - Residential,0,26,26,0.0,2021,8,Wednesday
2021-08-12,Faculty/Staff,Non-Residential,10,65,75,13.33,2021,8,Thursday
2021-08-12,Students,Students - Non-Residential,2,51,53,3.77,2021,8,Thursday
2021-08-12,Students,Students - Residential,0,31,31,0.0,2021,8,Thursday
2021-08-13,Faculty/Staff,Non-Residential,3,72,75,4.0,2021,8,Friday
2021-08-13,Students,Students - Non-Residential,2,41,43,4.65,2021,8,Friday
2021-08-13,Students,Students - Residential,0,77,77,0.0,2021,8,Friday
2021-08-14,Faculty/Staff,Non-Residential,1,11,12,8.33,2021,8,Saturday
2021-08-14,Students,Students - Non-Residential,1,2,3,33.33,2021,8,Saturday
2021-08-15,Faculty/Staff,Non-Residential,2,11,13,15.38,2021,8,Sunday
2021-08-15,Students,Students - Non-Residential,1,14,15,6.67,2021,8,Sunday
2021-08-15,Students,Students - Residential,1,215,216,0.46,2021,8,Sunday
